--------------
--------------
--------------
--------------
--------------
-------XX-----
-------XX-----
-------XX-----
----XX-X------
---XXX-XX-----
--XXX--XX-----
-XXXXX-XX-----
XXXXX--XX-----
XXXXX--XXXXXXX
