--------------
--------------
--SSSSSSSSSSSS
--------------
--------------
--------------
--------------
--------------
--------------
--------------
--------------
-----<>-------
-----[]-------
XXXXXXXX--XXXX
