--------------
--------------
--------------
--------------
--------------
--------------
--------------
XXXXX-XXX-----
--------------
--------------
--------------
--------------
--------------
----XXXXXXXXXX
