--------------
--------------
--------------
--------------
--------------
--------------
--------------
--------------
--------------
-Q------------
--------------
--------------
--------------
XXXXXXXXXXXXXX
