--------------
--------------
--------------
-E------------
---XXXX-------
--------------
--------------
--------------
--------------
--------XXXXXX
--------------
--------------
--------------
--------------
