--------------
--------------
SSSSSSSSSSSSSS
--------------
--------------
--------------
--------------
--------------
-----------E--
----E-----<>--
---<>-----[]--
---[]-----[]--
---[]-----[]--
XXXXXXXXXXXXXX
