--------------
--------------
--------------
--------------
--------------
----------EE--
---------XXXXX
--------------
--------------
----XXX-------
--------------
--------------
--------------
---XX---------
