--------------
--------------
--------------
--------------
--------------
----Q-Q-------
--------------
--------------
--------------
----Q---------
--------------
--------------
--------E-E---
XXXXXXXXXXXXXX
