--------------
--------------
--------------
--------------
--------------
--------------
--------------
--------------
--------------
--------------
--------------
-----------B--
-----------b--
XXXXXXXXX-XXXX
