--------------
--------------
--------------
--------------
--------------
--------------
--------------
--------------
--------------
-E---------E--
<>--------<>--
[]--------[]--
[]--------[]--
XXXXXXXXX-XXXX
