--------------
--------------
--------------
--------------
--------------
--------------
--------------
--------------
-------------E
--E---------<>
-<>---------[]
-[]---------[]
-[]---------[]
XXXXXXXXXXXXXX
