--------------
--------------
--------------
--------------
--------------
--------------
--------------
--------------
--------------
---E----------
--<>----------
--[]---------E
--[]----------
XXXXXXXXXXXXX-
