--------------
--------------
SSSSSSSSSSSSSS
--------------
--------------
--------------
--------------
--------------
--------------
-------QQQQ---
--------------
--------------
--------------
XXXXXXXXXX---X
