--------------
--------------
--------------
--------------
--------------
--------------
--------------
--------------
--------------
-------------E
-------E----<>
------<>----[]
----E-[]----[]
XXXXXXXXXXXXXX
