--------------
--------------
--------------
--XX----------
--------------
------XXX-----
--------------
--------------
--------------
----XXXXX-----
--------------
--------------
--------------
--------XXXXXX
