--------------
--------------
SSSSSSSSSSSS--
--------------
--------------
--------------
--------------
--------------
--------E-----
-------<>-----
----XX-[]---XX
---XXX-[]--XXX
-E-XXX-[]--XXX
XXXXX--XXXXXXX
