--------------
--------------
--------------
--------------
--------------
--------------
-------------X
--------------
--------------
---XXXXXXX----
--------------
--------------
--------------
XXX--------XX-
