--------------
--------------
-------o------
------XXXX----
--------------
--------------
-------------X
--------------
--------------
---X----------
-------XXXXX--
--------------
--------------
--------------
