--------------
--------------
SSSSSSSSSSSSSS
--------------
--------------
--------------
--------------
--------------
------E-------
E----<>-------
<>---[]-------
[]---[]-------
[]---[]-------
XXXXXXXXXXX-XX
