--------------
--------------
SSSSSSSSSSSSSS
--------------
--------------
--------------
--------------
--------------
--------------
-------------E
--X---------<>
--X---------[]
-XX-------E-[]
XXX--XXXXXXXXX
