--------------
--------------
--------------
--------------
--------------
--------------
--------------
------XXXXXXX-
--------------
XX------------
--------------
--XXX---------
--------------
-------------X
