--------------
--------------
--------------
--------------
--------------
--------------
--------------
--------------
--------------
-------Q------
--------------
--------------
-------------X
XXXXXXXXXXXXXX
