--------------
--------------
--------------
--------------
-------------E
-XXXX---------
--------------
--------------
--------------
-----------XX-
--------------
--------------
--------------
-----XXX------
