--------------
--------------
--------------
--------------
------X-------
--------------
--------------
XXXXX---------
----------XXX-
--------------
--------------
--------------
--------------
------XXXXX---
