--------------
--------------
SSSSSSSSSSSSSS
--------------
--------------
--------------
--------------
--------------
--------------
--------------
----E---------
---<>---------
---[]-----E-E-
-XXXXX-XXXXXXX
