--------------
--------------
--------------
--------------
--------------
---SSS--------
--------------
--------------
--------------
--------------
-E------------
<>------------
[]-----XXXX---
XXXX----------
