--------------
--------------
SSSSSSSSSSSSSS
--------------
--------------
--------------
--------------
--------------
--------------
-----Q-----E--
----------<>--
----------[]--
-----E----[]--
XXXXXXXXXXXXXX
