--------------
X-------------
-SSSSSSSSSSSSS
--SSSSSSSSSSSS
--SSSSSSSSSSSS
--SSSSSSSSSSSS
--SS----------
--------------
---?oo--------
---??SSSSSSS--
--------------
--------------
-------------X
---XXXXXXXXXXX
