--------------
--------------
SSSSSSSSSSSSSS
--------------
--------------
--------------
--------------
--------------
--------------
-------XX-----
----XXXXXXX---
-XXXXXXXXXX---
XXXXXXXXX-----
XXXXXXXXXXXXXX
