--------------
--------------
--------------
--------------
--------------
-------------Q
--------------
--------------
--------------
---X--------QQ
--XX----------
-XXXX---------
XXXXX---E---E-
XXXXXXXXXXXXXX
