--------------
--------------
--------------
--------------
--------------
----SSSSSSSSS-
--------------
--------------
--------------
--SS----------
--------------
--------------
--------------
XXXXXXXXXX----
