--------------
--------------
--------------
--------------
--------------
-XXXX---------
------o-------
-----XXX------
--------------
--------------
-----o--------
X---XXXX------
--------------
-------------X
