--------------
--------------
--------------
--------------
--------------
--------------
-----E--------
---XXXXXXXX---
--------------
--------------
--------------
XX------------
--------------
-------------X
