--------------
--------------
SSSSSSSSSSSSSS
SSSSSSSS------
SSSSSSSS------
SSSSSS------oo
--------------
------------SS
o-o---------SS
SSSSSSS-------
--------------
--------------
EE------------
XXXXXXXXXXXXXX
