--------------
--------------
SSSSSSSSSSSSSS
-----SSSSSSSSS
----SSSSSSSSSS
----SSSSSSSSSS
--------------
--------------
--------------
------SSSSSSSS
------SSSSSSSS
------SSSSSSSS
------S---S-SS
-----XXXXXXXXX
