--------------
--------------
SSSSSSSSSSSSSS
--------------
--------------
--------------
--------------
--------------
--------------
-------XXX----
------XX-XXX--
---XXXXXXXXX--
--XXXXXXXXXX-E
XXXXXXXXXXXXXX
