--------------
--------------
SSSSSSSSSSSSSS
SSSSSSSSSS----
SSSSSSSSSS----
SSSSSSSSSS---Q
--------------
--------------
----EEEE------
SSSSSSSSSS--QQ
SSSSSSSSSS----
SSSSSSSSSS----
SSSSSSSSSS----
XXXXXXXXXXXXXX
