--------------
--------------
--------------
--------------
--------------
------------E-
-X---------<>-
-----------[]-
-----------[]-
-----------XXX
--------------
--------------
--------------
--XXXXXXXXXX--
