--------------
--------------
--------SSSSSS
--------------
--------------
--------------
--------------
--------------
--------------
--------------
--------------
--------------
--------------
--------XXXXXX
