--------------
--------------
--------------
--------------
--------------
--------------
--------------
--------------
--------------
---------Q-Q--
--------------
--------------
---------E----
XXXXXXXXXXXXXX
