--------------
--------------
--------------
--------------
--------------
--------------
--------------
--------------
--------------
Q-------------
-------------E
--------------
--------------
XXXXXXXXXXXXXX
