--------------
--------------
--------------
--------------
ooo----------X
--------------
--------------
--------------
-------XXXX---
--------------
--------------
--XXXXX-------
--------------
--------------
