--------------
--------------
--------------
--------------
--------------
--------------
--------------
--------------
--------------
-------------E
---E--------<>
------------[]
----------E-[]
XXXXXXXXXXXXXX
