--------------
--------------
SSSSSSSSSSSSSS
----SS--SSSS--
----SS---SSS--
--SS-----S----
--SS----------
--SS----------
--SS----------
--SSSS--SSSS--
----SS--------
----SS--------
---E----------
XXXXXXXXXXXXX-
