--------------
--------------
SSSSSSSSSSS-SS
--------------
--------------
--------------
--------------
--------------
--------------
--------------
--------------
-----------XXX
--------------
XXXXXXXXX-----
