--------------
--------------
--------------
--------------
--------------
--------------
--------------
--------------
-----------E--
----------<>--
----------[]--
----------[]--
-------XXX[]--
XXXXXXXXXXXXXX
