--------------
--------------
--------------
--------------
--------------
--------------
--------------
--------------
--------------
-E--------E---
<>-------<>---
[]-------[]---
[]-------[]---
XXXXXXXXXXXXXX
