--------------
--------------
SSSSSSSSSSSSSS
--------------
--------------
--------------
--------------
--------------
--------------
--------------
-----------XXX
---------XXXXX
----EE--XXXXXX
-XXXXXXXXXX-X-
