--------------
--------------
--------------
--------------
--------------
--------------
--------------
-oo-----------
--------------
S-------------
--------------
--SS----------
--------------
X---XXXXXXXXXX
