--------------
--------------
--------------
--------------
--------------
--------------
--------------
--------------
--------------
--------------
--------------
---------B----
---------b----
---XXXXXXX-XXX
