--------------
--------------
--------------
--------------
--------------
--------------
--------------
--------------
--------------
--------------
--------------
X-------------
X----E--------
XXXXXXXXXXXXX-
