--------------
--------------
-SSSSSSSSSSSSS
--SSSSSSSSSSSS
--SSSSSSSSSSSS
--SSSSSSSSSSSS
--------------
--------------
-----------E--
----SSSSSSSSSS
----SSSSSSSSSS
----SSSSSSSSSS
-------SSSSSSS
---XXXXXXXXXXX
