--------------
--------------
--------------
--------------
--------------
--SSSSSS------
--------------
--------------
--------------
Q-----SQS-----
-------------E
------------<>
------------[]
XXXXXXXXXXXXXX
