--------------
--------------
--------------
--------------
--------------
--------------
--------------
--------------
--------------
------------E-
-----------<>-
----------<[]-
----------[]]-
---XXXXXXXXXXX
