--------------
--------------
--------------
--------------
--------------
--------------
--------------
--------------
--------------
----------E---
---------<>--E
---------[]-<>
--EE-EE--[]-[]
XXXXXXXXXXXXXX
