--------------
--------------
SSSSSSSSSSSSSS
--------------
--------------
--------------
--------------
--------------
--------------
----E---------
---<>---------
---[]---------
---[]---------
XXXXXXXXXXXXXX
