--------------
--------------
-SSSSSSSSSSSSS
--------------
--------------
--------------
--------------
--------------
--------------
--------------
--------------
--------------
-----------E-E
--XXXXXXXXXXXX
