--------------
--------------
--------------
--------------
--------------
SSSSS-----SSSS
--------------
--------------
--------------
--S-----------
--------------
--------------
--------------
XXXXXX--XXXXXX
