--------------
--------------
--------------
--------------
--o-----------
-X------------
-----------E--
---------XXXXX
--------------
-X------------
--------------
----XXX-------
--------------
--------------
