--------------
--------------
--------------
--------------
--------------
--------------
--------------
--------------
---------E----
--E-----<>----
-<>-----[]----
-[]-----[]----
-[]-----[]----
XXXXXXX-XXXXXX
