--------------
--------------
--------------
--------------
--------------
--------------
--------------
--------------
--------------
------Q---SS--
--------------
--------------
--------------
XXXXXXXXXXXXXX
