--------------
--------------
--------------
--------------
--------------
--------------
--------------
---------XSS--
--------XX----
-------XXX---S
------XXXX----
-----XXXXX----
----XXXXXXX---
XXXXXXXXXX----
