--------------
--------------
--------------
--------------
--------------
--------------
--------------
--------------
--------------
---------Q----
--------------
--------------
---E----------
XXXXXXXXXXXXXX
