--------------
--------------
SSSSSSSSSSSSSS
----SS--SSSS--
----SS--SSSS--
--SSS---------
--SS----------
--SS----------
--SS-----oo---
---SSS--SSSS--
----SS--------
----SS--------
----S-----E---
-XXXXXXXXXXXXX
