--------------
--------------
--------------
--------------
--------------
--------------
--------------
--------------
--------------
-Q------------
--------------
--------------
E-------------
XXXXXXXXXXXXXX
