--------------
--------------
SSSSSSSSSSSSSS
S---SSSS------
----SSSS--E---
-----S----SS--
----SS----SS--
-----S----SS--
-----Soo?-SS--
-----SSSS-SS--
--------------
XX------------
--------------
---XXXXXXXXXXX
