--------------
--------------
--------------
--------------
--------------
--------------
--------------
--------------
---------E----
---E----<>----
--<>----[]----
--[]----[]----
--[]----[]----
XXXXXXXXXXXXXX
