--------------
--------------
----SSSSSSSSSS
--------------
--------------
---S----------
--------------
--------------
--S-----------
--------------
--------------
--------------
------E-E-E--E
XXXXXXXXXXXXXX
