--------------
--------------
--------------
--------------
--------------
--------------
--------------
--------------
--------------
--------------
--------------
------------X-
--------------
XXXXXXXXXXXXXX
