--------------
--------------
--------------
--------------
--------------
--------------
--------------
--------------
--------------
--------------
--------------
--------------
E-E--E-------E
XXXXXXXXXXXXXX
