--------------
--------------
SSSSSSSSSSSSSS
--------------
--------------
--------------
--------------
--------------
-E------------
<>------------
[]------------
[]------------
[]------------
XX--XXXXXXXX-X
