--------------
--------------
--------------
--------------
--------------
--------------
--------------
--------------
--------------
---------QQ---
-----------E--
-----B--------
-----b--------
XXXXXXXXXXXXXX
