--------------
--------------
--------------
--------------
--------------
--------------
--------------
--------------
--------------
---------E----
--------<>----
--------[]----
---E----[]----
-XXXXXXXXXXXXX
