--------------
--------------
--------------
--------------
--------------
--------------
--------------
--------------
--------------
--E-----------
-<>-----------
-[]-----------
-[]-----------
XXXXXXXXXX--XX
