--------------
--------------
SSSSSS-----SSS
--------------
--------------
--------------
--------------
--------------
-------------S
------------SS
----XX-X------
---XXXXX------
--XXXX--------
XXXXX------XXX
