--------------
--------------
--------------
-------------o
--------------
------------XX
-o------------
--------------
--------------
--------------
------XXX-----
--------------
--------------
-XXXX--------X
