--------------
--------------
SSSSSSSSSSSSSS
SSSSS-SSSSSSSS
SSSS--SSSSSSSS
SSSS--SSSSSSSS
--------------
--------------
---------o--oo
--------SSSSSS
--------------
--------------
--------E-----
--XX-XXXXXXXXX
