--------------
--------------
--------------
--------------
--------------
--------------
--------------
--------------
--------------
--------------
-----E----E---
----<>--------
----[]-------E
XXXXXXXXXXXXXX
