--------------
--------------
--------------
--------------
--------------
--------------
--------------
--------------
----E---------
---<>---SS----
---[]---------
---[]---------
---[]---------
XXXXXXXXXXXXXX
