--------------
--------------
--------------
--------------
--------------
--------------
--------------
--------------
--------------
SS------------
--------------
--------------
--------------
XXXXXXXXXXXXXX
