--------------
--------------
--------------
--------------
--------------
--------------
--------------
--------------
--------------
--------------
--------------
--------------
-----------EEE
-XXXXXXXXXXXXX
