--------------
--------------
--------------
--------------
--------------
----SSSSSSSS--
--------------
--------------
--------------
--------------
--------------
--------------
--------------
XXXXXXXXXX---X
