--------------
--------------
--------------
--------------
--------------
--------------
--------------
--------------
--------------
--------E-----
-------<>----<
-------[]----[
--E--E-[]----[
XXXXXXXXXXXXXX
