--------------
--------------
--------------
--------------
--------------
--------------
--------------
-------------X
------------XX
---SSS-----XXX
----------XXXX
---------XXXXX
---------XXXXX
XXXXXXXXXXXXXX
