--------------
--------------
--------------
--------------
--------------
--------------
--------------
--------------
--------------
--------------
--------------
--------------
--E-EE------EE
XXXXXXXXXXXXXX
