--------------
--------------
--------------
----------XXXX
--------------
--------------
XXXX----------
--------------
--------------
--------------
----------XXXX
---XXXX-------
--------------
--------------
