--------------
--------------
--------------
--------------
--------------
--------------
--------------
--------------
--------------
----------E---
---------<>---
---------[]---
-EE-E----[]---
XXXXXXXXXXXXXX
