--------------
--------------
--------------
--------------
--------------
--------------
--------------
--------------
--------------
--------------
---E----------
--<>----------
--[]-E--------
XXXXXXXXXXX---
