--------------
--------------
SSSSSSSSSSSSSS
SSSSSSSSSSSSSS
SSSSSSSSSSSSSS
SSSSSSSSSSSSSS
--------------
--------------
?------------E
??SSSSSSSSSSSS
--SSSSSSSSSSSS
--SSSSSSSSSSSS
o-SSSSSSSSSSSS
XXXXXXXXXXXXXX
