--------------
--------------
--------------
--------------
--------------
--------------
--------------
--------------
-----XXXX-----
--------------
-X-----------X
--------------
--------------
--------XXXX--
