--------------
--------------
--SSSSSSSSSSSS
--------------
--------------
--------------
--------------
--------------
--------------
-------------<
-------------[
------------<[
----E-EE----[]
XXXXXXXXXXXXXX
