--------------
--------------
--------------
--------------
--------------
--------------
--------------
-----XXXXXX---
--------------
--------------
--------------
XXX-----------
------------oo
------------XX
