--------------
--------------
SSSSSSSSSSSSSS
------SSSSSSSS
------SSSSSSSS
------SSSSSSSS
------S-------
------S-------
--------oooooo
-------??SSSSS
--------------
--------------
--------------
X------XXXXXXX
