--------------
--------------
--------------
--------------
--------------
----XX-----XX-
--------------
--------------
--------------
--------------
--------------
--------------
--------------
XXX----XXXXXX-
