--------------
--------------
SSSSSSSSSSSSSS
--------------
--------------
--------------
--------------
--------------
--------------
--------------
--------------
-------------E
---------EE--E
XXXXXXXXXXXXXX
