--------------
--------------
SSSSSSSSSSSSSS
SSSSSSSSSS----
SSSSSSSSSS----
SSSSSSSSSS----
S-------------
--------------
--oooo--------
--SSSSSSSS----
--------------
--------------
--------------
XXXXXXXXXXXXXX
