--------------
--------------
--------------
--------------
--------------
--------------
--------------
--------------
--------------
---E-------E--
--<>------E---
--[]-----<>---
--[]-----[]---
XXXXXXXXXXXXXX
