--------------
--------------
--------------
--------------
--------------
--------------
--------------
-------XXXXXXX
--------------
-X------------
----XXX-------
--------------
--------------
------------XX
