--------------
--------------
SSSSSSSSSSSSSS
--------------
--------------
--------------
--------o-----
--------------
--------------
-X-X----------
XXXXXX---XX---
XXXXXXX--XXXX-
XXXXXXX--XXX--
XXXXXXXXXXXXXX
