--------------
--------------
--------------
--------------
--------------
--------------
--------------
--------------
--------------
--------------
-------------<
-------------[
------EEEE---[
-XXXXXXXXXXXXX
