--------------
--------------
--------------
--------------
--------------
SSSS----------
--------------
--------------
--------------
--------------
---E---------E
-------B------
-------b------
XXXXXXXXXXXXXX
