--------------
--------------
SSSSSSSSSSSSSS
SSSSSSSSSSSSSS
SSSSSSSSSSSSSS
SSSSSSSSSSSSSS
--------------
--------------
?---------E---
?-SSSSSSSSSSSS
--SSSSSSSSSSSS
--SSSSSSSSSSSS
ooSSSSSSSSSSSS
-XXXXXXXXXXXXX
