--------------
--------------
--------------
--------------
--------------
--------------
--------------
--------------
--------------
------------E-
-----------<>-
-----E-----[]-
-E---------[]-
XXXXXXXXXXXXXX
