--------------
--------------
--------------
--------------
--------------
--------------
--------------
--------------
--------------
--------------
--XXX---------
--------------
--------------
X------XXXXXXX
