--------------
--------------
--------------
--------------
--------------
--------------
--------------
--------------
--------------
SQ------------
--------------
--------------
-----------E-E
XXXXXXXXXXXXXX
