--------------
--------------
--------------
--------------
--------------
--------SSSS--
--------------
---E----------
--------------
--------------
---------E----
--------<>----
--------[]----
XXXXXXXXXXXXXX
