--------------
--------------
--------------
--------------
--------------
--------------
--------------
--------------
--------------
--------------
------XXXXX---
--------------
--------------
-XXXX-------XX
