--------------
--------------
--------------
--------------
--------------
------SQS-----
--------------
--------------
--------------
-------SS-----
--------------
--------------
--EE-E--------
XXXXXXXXXXXXXX
