--------------
--------------
--------------
--------------
--------------
--------------
--------------
--------------
-----EE-------
---SSSSSS-----
--------------
--------------
--------------
XXXXXXXXXXXXXX
