--------------
--------------
--------------
--------------
--------------
--------------
--------------
--------------
-----SSSS-----
--------------
--------------
--------------
--------------
XXXXXXXXXXXXXX
