--------------
--------------
--------------
--------------
--------------
--------------
--------------
--------------
--------------
--------------
-------------<
-------------[
-------E-E---[
XXXXXXXXXXXXXX
