--------------
--------------
--------------
--------------
--------------
--------------
--------------
--------------
--------------
----------E---
---E-----<>---
---------[]--<
---------[]--[
XXXXXXXXXXXXXX
