--------------
--------------
--------------
--------------
--------------
--------------
--------------
--------------
--------------
--------------
--------------
-------------X
--------------
-XX-XXXXXXX---
