--------------
--------------
SSSSSSSSSSSSSS
SSSSSSSS------
SSSSSSSS------
SSSSSSSS------
--------------
--------------
-----E--------
SSSSSSSS--QQ--
SSSSSSSS------
SSSSSSSS------
SSSSSSSS------
XXXXXXXX-XXXXX
