--------------
--------------
SSS-SSSSSSSSSS
------------SS
--------------
---SSSS-------
--------------
--------------
--------------
---S-SSS------
--------------
--------------
----E---------
XXXXXXXXX----X
