--------------
--------------
SSSSSSSSSSSSSS
--------------
--------------
--------------
--------------
--------------
--------------
---------Q-QQ-
-XX-----------
-XXXX---------
-XXXX---------
XXXXXXXXXXXXXX
