--------------
--------------
--------------
--------------
--------------
--------------
--------------
-----------X-S
-----------XX-
---------XXXX-
--------XXXXX-
-------XXXXXX-
------XXX--XX-
XXXXXXXXXXXX--
