--------------
--------------
--------------
--------------
--------------
--------------
--------------
---XXXXXXXX---
--------------
--------------
--------------
--------------
-------------o
-------------X
