--------------
--------------
--------------
--------------
--------------
--------------
--------------
--------------
--------------
-------------E
-------------[
------------[]
-----EEEEE---[
XXXXXXXXXXXXXX
