--------------
--------------
SSSSSSSSSSSSSS
SSSS------SSSS
SSSS------SSSS
-S----SS------
------SS------
SS----SS------
-S----SS---E--
-SS---SS--SSSS
---------E----
--------------
--------E-----
XXXXXXXXXXXXXX
