--------------
--------------
--------------
--------------
--------------
SS------------
--------------
--------------
-------E------
------<>------
------[]------
------[]------
--E---[]------
XXXXXXXXXXXXXX
