--------------
--------------
--------------
--------------
--------------
--------------
--------------
--------------
--------------
--------------
-E------------
<>------------
[]---------E--
XXXXXXXXXXXXXX
