--------------
--------------
--------------
--------------
--------------
--------------
--------------
--------------
--------------
--------------
----------<>--
----------[]--
----------[]--
XXXXXXXXXXXXXX
