--------------
--------------
--------------
--------------
--------------
--------------
--------------
--------------
--------------
--------------
--SS--------E-
---S-------<>-
-----------[]-
X----XXX--XXXX
