--------------
--------------
S-----SSSSSSSS
--------------
--------------
--------------
--------------
--------------
--------------
----XXX-------
XX-----------E
XX----------<>
------------[]
----------XXXX
