--------------
--------------
--------------
--------------
--------------
--------------
--------------
--------------
--------------
------E---QQQ-
-----<>-------
-----[]-------
-E---[]-------
XXXXXXXXXXXXXX
