--------------
--------------
--------------
--------------
--------------
--------------
--------------
--------------
----E---------
---<>--------E
---[]-------<>
---[]-------[]
---[]-------[]
XXXXXXXXXXXXXX
