--------------
--------------
SSSSSSSSSSSSSS
--------------
--------------
-------------o
--------------
---------S-SSS
----------oSSS
---------SSSS-
--X-----------
-XXXXX--------
XXXX----------
XXX-----XXXXXX
