--------------
--------------
--------------
--------------
--------------
-SSS----------
--------------
--------------
--------------
XXXX----------
X-------------
--------------
-------------E
-------XXXXXXX
