--------------
--------------
--------------
--------------
--------------
--------------
--------------
--------------
--------------
--------------
--------------
--------------
-EEEE---------
XXXXXXXXXXXXXX
