--------------
--------------
--------------
--------------
--------------
--------------
--------------
--------------
--------------
-----------Q-Q
-----------E--
--------------
--------------
-XXXXXXXXXXXXX
