--------------
--------------
SSSSSSSSSSSSSS
-----SSSSSSSSS
-------SSS-SSS
--SS--SSSSSSSS
--SS----------
--SS----------
--SS---E------
--SS--SSSS----
--------------
------------XX
------------XX
XXXXXXXXXXXXXX
