--------------
--------------
--------------
--------------
--------------
--------------
--------------
--------------
--------------
SS------------
------E-----E-
-----<>-------
-----[]-------
XXXXXXXXXX-XXX
