--------------
--------------
--------------
--------------
--------------
--------------
--------------
--------------
--------------
-XX-----------
-XX-----------
-XX--SSS------
XXX-----------
XX------XXXXXX
