--------------
--------------
--------------
--------------
--------------
--------------
--------------
--------------
--------------
------SS-S----
--------------
--------------
--------------
XXXXXXXXXXXXXX
