--------------
--------------
o-------------
--------------
--------------
--------------
--------------
--------------
----XX--------
--------------
XXX-----------
--------------
-------------E
-----X--XXXXXX
