--------------
--------------
---SSSSSSSSSS-
--------------
--------------
--------------
--------------
--------------
--------------
--------E-----
-------<>--XXX
-------[]--XXX
-------[]--XXX
XXXXXXXXXXXXX-
