--------------
--------------
--------------
--------------
--------------
--------------
--------------
--------------
--------------
------------E-
-----------<>-
-----------[]-
-----------[]-
-XXXXXXXXXXXXX
