--------------
--------------
--------------
--------------
--------------
--------------
--------------
--------------
-------------X
------------XX
-----------XXX
-XX-------XXXX
-XXX------XXXX
XXXXXXXXXXXXXX
