--------------
--------------
--------------
--------------
--------------
--------------
--------------
--------------
--------------
--------------
--------------
--------------
--E-----EEEE--
XXXXXXXXXXXXXX
