--------------
--------------
--------------
--------------
--------------
--------------
--------------
--------------
--------------
--------------
------<>------
------[]------
------[]------
XXXXXXXXXXXXXX
