--------------
--------------
--------------
--------------
--------------
--------------
--------------
--------------
-------------X
-----X------XX
----XX-----XXX
---XXX----XXXX
--XXXX--XXXXXX
XXXXXXXXX-XXXX
