--------------
--------------
--------------
--------------
--------------
--------XX----
-------XXX----
------XXXX----
-----XXXXX----
----XXXXXX----
---XXXXXXX----
---XXXXXXX----
-XXXXXXXXX----
XXXXXX-XXXXXXX
