--------------
--------------
SSSSSSSSSSSSSS
--------------
--------------
--------------
--------------
--------------
--------------
-----E--------
----<>--------
----[]--------
----[]-------X
XXXXXX--XXXXXX
