--------------
--------------
SSSSSSSSSSSSSS
--------------
--------------
--------------
--------------
--------------
--------------
--------------
--------------
--------------
E-EE-----E-E--
XXXXXXXXXXXXXX
