--------------
--------------
--------------
--------------
--------------
--------------
--------------
--------------
--------------
--------------
---------XXXX-
--------------
--------------
XXXXXXXXX-----
