--------------
--------------
--------------
--------------
--------------
--------------
--------------
-E------------
<>------------
[]------------
[]------------
[]------------
[]------------
XXXXXXXXX----X
