--------------
--------------
--------------
--------------
--------------
--------------
XXXXX---------
--------------
--------XXX---
--------------
--------------
----XXX-------
--------------
--------------
