--------------
--------------
--------------
--------------
--------------
--------------
--------------
--------------
--------------
--------XXXXXX
--------------
--------------
--------------
X-X-XXX-------
