--------------
--------------
SSSSSSSSSSSSSS
SSSSSS--SSSSSS
SSSSSS---SSSSS
SSSSSS--SSSSSS
--------------
--------------
-E-E----------
SSSS------SSSS
SSSSSS----SSSS
SSSSSS----SSSS
SSSSS---------
XXXXX----XXXXX
