--------------
--------------
--------------
--------------
--------------
--------------
--------------
--------------
--------------
--------------
--------------
--------------
----------EE-E
XXX----XXXXXXX
