--------------
--------------
--------------
--------------
--------------
--------------
--------------
--------------
--------------
--------------
--------------
--------------
----EE-------E
XXXXXXXXXXXXXX
