--------------
--------------
---------oo---
---------XXX--
--------------
--------------
--------------
--------------
--------------
-----XXX----XX
--------------
--------------
--------------
XXXX----------
