--------------
--------------
SSSSSSSSSSSSSS
--------------
--------------
--------------
--------------
--------------
--------------
----XXXX------
--XXXXXXX-----
-XXXX-XXXX----
XXXXX-XXXX----
XXXXXXXXXXXXXX
