--------------
--------------
--------------
--------------
--------------
--------------
--------------
--------------
--------------
--------------
--------------
--------------
----------EE-E
-X-XXXXXXXXXXX
