--------------
--------------
--------------
--------------
--------------
--------------
--------------
--------------
--------------
-----------E--
-----E----<>--
----<>----[]--
----[]----[]--
XXXXXXXXXXXXXX
