--------------
--------------
--------------
--------------
--------------
--X-----------
-XX-----------
-XX-----------
-XX-----------
-XX-----------
-XX-----------
-XXX----------
-XXX----------
-XXXXXXXXXXXXX
