--------------
--------------
SSSSSSSSSSSSSS
SSSSSSSSSSSSSS
SSSSSSSSSSSSSS
SSSSSSSSSSSSSS
--------------
--------------
?-------------
?SSSSSSSSSSSS-
--SSSSSSSSS---
--SSSSSSSSSS--
ooSSSSSSSSS---
XXXXXXXXXXXXXX
