--------------
--------------
--------------
--------------
--------------
--------------
--------------
--------------
--------------
-----E------SS
----<>----E---
----[]--------
E-E-[]--------
XXXXXXXXXXXXXX
