--------------
--------------
--------------
--------------
--------------
--------------
--------------
--------------
--------------
--------------
--------------
--------------
---E-EE-------
XXXXXXXXXXXXXX
