--------------
--------------
--------------
--------------
--------------
SSSSSS--------
--------------
--------------
---E----------
SSSSSSS-----E-
-----------<>-
-----------[]-
-----------[]-
XXXXXXXXXXXXXX
