--------------
--------------
--------------
--------------
----o---------
--------------
--------------
----XXXXXX----
--------------
----------oo--
--------------
----XXXXXXX---
--------------
--------------
