--------------
--------------
--------------
--------------
--------------
---------SSSSS
--------------
--------------
-o------------
------------ES
--------E-----
--------------
--------------
---XXXXXXXXXXX
