--------------
--------------
--------------
--------------
-o------------
XXXX----------
--------------
--------------
--------------
-X--------X-X-
--------------
--------------
--------------
-----XXXX----X
