--------------
--------------
--------------
--------------
--------------
--SS----------
--------------
--------------
--E--<>-------
-<>--[]-------
-[]--[]-------
-[]--[]-------
-[]--[]-------
-XX--XXXXXX---
