--------------
--------------
SSSSSSSSSSSSS-
--------------
--------------
--------------
--------------
--------------
--------------
QQQ--------XXX
---------XXXXX
------XXXXXXXX
-E--XXXXXXXXXX
XXXXXXXXXXXXXX
