--------------
--------------
--------------
--------------
--------------
---SSSSS------
--------------
--------------
--------------
----SSSS------
--------------
----------X---
----E-----X---
XXXXXXXXXXXXXX
