--------------
--------------
--------------
--------------
--------------
--------------
--------------
--------------
--------------
--------------
--------------
--------------
---EEE--------
XXXXXXXXXXXXXX
