--------------
--------------
--------------
--------------
--------------
--------------
--------------
--------------
--------------
--------------
--------------
--------------
------E-E-E---
X-XXXXXXXXXXXX
