--------------
--------------
SSSSSSSSSSSSSS
------SSSSSS--
------SSSSSS--
------SSSSSS--
--------------
--------------
--------E-----
--------SSSS--
--------SSSS--
--------SSS---
--------------
-------XXXXXX-
