--------------
--------------
SSSSSSSSSSSSSS
------------SS
------------SS
----------SS--
----------SS--
----------SS--
---SS-----SS--
---SS-----SSSS
------------SS
-------------S
-----------E--
XXXXXXXXXXXXXX
