--------------
--------------
-----------SSS
S-------------
--------------
--------SS----
--------------
--------------
--------------
--------------
--------------
--------------
--------------
XXXXXX-----XXX
