--------------
--------------
--------------
--------------
--------------
--------------
--------------
--------------
--------------
o-------------
--------------
--------------
--------------
XXXXXX-XXXX--X
