--------------
--------------
--------------
--------------
--------------
------S-------
--------------
--------------
--------------
------------E-
---E-------<>-
--<>-------[]-
--[]-------[]-
XXXXXXXXXXXXXX
