--------------
--------------
--------------
--------------
--------------
--------------
----------E---
---------<>---
---------[]---
---------XXX--
--------------
--------------
--------------
XXXXXXXXXXXXXX
