--------------
--------------
SSSSSSSSSSSSSS
--------------
--------------
--------------
--------------
--------------
--------------
----E---------
---<>----<>---
---[]----[]---
---[]----[]---
XXXXXXXXXXXXXX
