--------------
--------------
--------------
--------------
--------------
-------------E
-----------X-X
--------------
--------------
------XXXX----
--------------
--------------
-XXX----------
--------------
