--------------
--------------
--------------
--------------
--------------
-----------SSS
--------------
--------------
--------------
--E--------XXX
-<>-----------
-[]----------X
-[]-----EE---X
XXXXXXXXXXXXXX
