--------------
--------------
--------------
--------------
--------------
--------------
--------------
--------------
--------------
--------------
--------------
--------------
E-E----E-E--E-
XXXXXXXXXXXXXX
