--------------
--------------
------o-------
-----XXX------
-------------X
X-------------
X-------------
--------------
--------------
--------------
--------------
--XXXXX-------
--------------
--------------
