--------------
--------------
--------------
--------------
--------------
SSSS----------
--------------
--------------
------E-------
-----<>-------
-----[]-------
-----[]-------
-----[]---EEE-
XXXXXXXXXXXXXX
