--------------
--------------
SSSSSSSSSSS-S-
--------------
--------------
--------------
--------------
--------------
--------------
--------------
----------XX--
--------EXXXXX
--------XXXX--
---XXXXXXXX---
