--------------
--------------
--------------
--------------
--------------
------SSSSS---
--------------
--------------
--------------
Q-------------
--------------
--------------
--------------
XXXXX----XXXXX
