--------------
--------------
-------------o
-E-----------X
XXXX----------
--------------
--------------
--------------
--------------
-----------XXX
--------------
--------------
--------X-----
XXXXX---------
