--------------
--------------
--------------
--------------
--------------
--------------
--------------
--------------
--------------
------------XX
--------------
--------------
--------X-----
XXXXX---XXX---
