--------------
--------------
--------------
--------------
--------------
--------------
--------------
--------------
-----E--------
----<>--------
----[]--------
----[]--------
----[]--E-----
XXXXXXXXXXXXXX
