--------------
--------------
--------------
--------------
--------------
-------------S
--------------
--------------
---------E----
-E------<>--S-
<>------[]----
[]------[]----
[]------[]----
XXXXXXXXXX-XXX
