--------------
--------------
----SSSSSSSSSS
--------------
--------------
--SS----------
--------------
--------------
--------------
------------E-
-E---------<>-
<>---------[]-
[]---------[]-
XX--XXXXXXXXXX
