--------------
--------------
SSSSSSSSS-----
SS------------
SS------------
SS------------
--------------
--------------
--------------
SS---QQ-Q-----
--------------
--------------
--------------
XXXXXXXX------
