--------------
--------------
--------------
--------------
--------------
--------------
--------------
--------------
--------------
---------E----
--------<>----
--------[]----
--E-----[]-E--
XXXXXXXXXXXXXX
