--------------
--------------
SSSSSSSSSSSSSS
---SSSSSSSSSSS
--SSSSSSSSSSSS
--SSSSSSSSSSSS
--------------
--------------
------------E-
----SSSSSSSSSS
----SSSSSSSSSS
----SSSSSSSSSS
------------SS
---XXXXXXXXXXX
