--------------
--------------
SSSSSSSSSSSSSS
SSSSSSSSSSSSSS
SSSSSSSSSSSSSS
SSSSSSSSSSSSSS
--------------
--------------
------E-------
--SSSSSSSSSSSS
SSSSSSSSSSSSSS
SSSSSSSSSSSSSS
S-SSSSSSSSSSSS
XXXXXXXXXXXXXX
