--------------
--------------
SSSSSSSSSSSSSS
----SSSSSSSSSS
----SSSSSSSSSS
----SSSSSSSSSS
--------------
--------------
------------E-
-------SSSSSSS
------SSSSSSSS
------SSSSSSSS
-----------SSS
-----XXXXXXXXX
