--------------
--------------
SSSSSSSSSSSSSS
--------------
--------------
--------------
--------------
--------------
--------------
------------X-
---------X----
-------XXX----
-------XXX----
XXXXXX-X-----X
