--------------
--------------
--SSSSSSSSSSSS
--------------
--------------
--------------
--------------
--------------
--------------
--------------
--------------
--------------
-----E--------
XXXXXXXXX----X
