--------------
--------------
--------------
--------------
--------------
--------------
-----------E--
-X-------XXXXX
--------------
--------------
--------------
--XXXXX-------
--------------
--------------
