--------------
--------------
--------------
--------------
--------------
--------------
--------------
--------------
--------------
----------E---
---------<>---
---------[]---
---------[]E--
-XXXXXXXXXXXXX
