--------------
--------------
--------------
--------------
--------------
--------------
--------------
--------------
--------------
-----------Q--
--------------
--------------
EE------------
XXXXXXXXXXXXXX
