--------------
--------------
--------------
--------------
--------------
--------------
--------------
--------------
--------E-----
-------<>-----
-------[]----<
-------[]----[
--E----[]----[
XXXXXXXXXXXXXX
