--------------
--------------
--------------
--------------
--------------
--------------
--------------
--------------
o----o--------
--------------
--------------
--------------
------------X-
--XX---XXXXXXX
