--------------
--------------
--------------
--------------
--------------
--------------
-----------E--
---X-----XXXXX
------X-------
--------------
--------------
-XXXX---------
--------------
--------------
