--------------
--------------
--------------
--------------
-------------o
------------XX
--------------
--------------
--------------
-----XX-------
--------------
---------XX---
----o---------
--XXXX-------X
