--------------
--------------
--------------
--------------
--------------
--------------
--------------
--------------
--------------
--------------
--------------
--------------
---E--E--EE--E
XXXXXXXXXXXXXX
