--------------
--------------
--------------
--------------
--------------
--------------
--------------
--------------
-------------E
------------<>
-----------E[]
----------<>[]
-----E----[][]
XXXXXXXXXXXX-X
