--------------
--------------
--------------
--------------
--------------
--------------
--------------
--------------
oo------------
--------------
--------------
--------------
--------------
-XXXXXXXXXX---
