--------------
--------------
--------------
--------------
--------------
--------------
--------------
--------------
------------S-
--------------
--------------
--------------
--------------
XXXXXXXXXXXX--
