--------------
--------------
SSSSSSSSSSSSSS
--------------
--------------
--------------
--------------
--------------
-------------S
------------SS
--------------
--------------
--------------
XXXXXXX-X--XXX
