--------------
--------------
SSSSSSSSSSSSSS
--------SSSSSS
--------SSSSSS
--------SSSSSS
--------------
--------------
--------------
---------SSSSS
--------SSSSSS
---------SSSS-
-------------o
--X-----XXXXXX
