--------------
--------------
--------------
--------------
--------------
--------------
--------------
--------------
------------E-
--E---SS---<>-
-<>--------[]-
-[]--------[]-
-[]--------[]-
XXXXXXXXXXXXXX
