--------------
--------------
--------------
--------------
--------------
---------E----
--------------
--XXXXX-------
--------------
X----------XXX
--------------
--XX----------
---------oo---
--------XXX---
