--------------
--------------
--------------
--------------
--------------
--------------
-----------o--
XXXXX-XXX-XXX-
--------------
--------------
--------------
--------------
---E-----E----
XXXXXXXXXXXXXX
