--------------
--------------
SSSSSSSSSSSSSS
--------------
--------------
--------------
--------------
--------------
-E-------S----
<>-----E------
[]----<>-----E
[]----[]----<>
[]-E--[]----[]
XXXXXXXXXXXXXX
