--------------
--------------
--------------
--------------
--------------
--------------
--------------
--------------
--------------
--------------
-----------E--
--------------
--E-E-EE------
XXXXXXXXXXXXXX
