--------------
--------------
--------------
--------------
--------------
--------------
--------------
--------------
--------------
-------------Q
---X---------[
---XX---------
---XX-----E---
XXXXXXXXXXXXXX
