--------------
--------------
--------------
--------------
--------------
--------------
--------------
--------------
-------------E
------------<>
------------[]
------------[]
-------E----[]
---XXXXXXXXXXX
