--------------
--------------
--------------
--------------
--------------
--------------
--------------
--------------
---oo---------
---------XXXXX
--------------
--------------
--------------
XXX-XXX------X
