--------------
--------------
SSSSSSSSSSSSSS
--------------
--------------
-----------ooo
--------------
-----------SSS
----------o---
---------SSSS-
--------------
--------------
------------EE
---XX-XXXXXXXX
