--------------
--------------
SSSSSSSSSSSSSS
--------------
--------------
oo------------
--------------
-SSS----------
SSSS----------
-S------------
-------------E
------------<>
------------[]
XXXXXXXXXXXXXX
