--------------
--------------
--------------
--------------
--------------
--------E---SS
-------<>-----
-------[]-----
-------[]-----
-E-----XXX----
<>------------
[]------------
[]-----E------
XXXXXXXXXXXXXX
