--------------
--------------
--------------
--------------
--------------
--------------
--------------
--------------
--------------
--------------
----XX--------
--------------
-------------E
XXXX----XXXXXX
