--------------
--------------
--------------
--------------
--------------
X-------------
--------------
--------------
--XX----------
--------------
--------------
--------------
--------------
-----XXXXXXX--
