--------------
--------------
SSSSSSSSSSSSSS
SSSSSSSS------
SS--SS-S------
SS---SS-------
--------------
--------------
S-------------
SS------------
---------XXXX-
-------XXXXXX-
-E-----XXXXXX-
XXXXXXXXXXXXXX
