--------------
--------------
--SSSSSSSSSSSS
--------SS----
--------S-----
-SSS--SSS-----
--------------
--------------
--------------
--QS--SSSS----
--------------
--------------
-----E--------
XXXXXXXXXX---X
