--------------
--------------
--------------
--------------
--------------
SSSSSSSSQS----
--------------
--------------
--------------
---S---SSS----
--------------
--------------
--------------
XXXXXXXXXXXXXX
