--------------
--------------
--------------
-------XX-----
-------XX-----
-------XX-----
-------XX-----
-------XX-----
-------XX-----
---S---XX-----
-------XX-----
-------XX-----
-------XX-----
XXXXXXXXXXXXXX
