--------------
--------------
SSSSS-SSSSSSSS
--------------
---------SS---
----SS----S---
---SSS--------
----S---------
---SSS---SS---
---SS----SS---
--------------
--------------
------E-------
XXXXXXXXXXXXXX
