--------------
--------------
--------------
--------------
--------------
--------------
--------------
--------------
--------------
----------X---
----XXX-XXX---
---XXXX---XXXX
--XXXXX--XXXXX
XXXXXXX--XXXXX
