--------------
XXX-----------
----SSSSSSSSSS
----SSSSSSSSSS
----SSSSSSSSSS
----SSSSSSSSSS
----S---------
----S---------
-----?oo------
-----??SSS?-SS
------------SS
-X----------SS
-----E-----oSS
-----XXXXXXXXX
