--------------
--------------
--------------
--------------
--------------
--------------
--------------
--------------
--------------
---------E--E-
-------XXXXXXX
--------------
--------------
---XXXX-------
