--------------
--------------
--------------
--------------
--------------
--------------
--------------
--------------
--------------
------------S-
--------------
--------------
----E---------
XXXXXXXXXXXXXX
