--------------
--------------
--------------
--------------
--------------
--------------
-----------XXX
--------------
--------------
--------------
----XXXXXXXX--
--------------
--------------
XX------------
