--------------
--------------
--------------
--------------
--------------
-------X------
-------X------
-----XXX------
----XXXX------
----XXXX------
---XXXXX------
--XXXXXX-----E
-X-XXXXX-----E
XXXXXX---XXXXX
