--------------
--------------
SSSSSSSSSSSSSS
--------------
--------------
-------------o
--------------
-----------S-S
--------------
---E--S---SSSS
--<>----------
--[]----------
--[]----------
XXXX-XXXXXXXXX
