--------------
--------------
--------------
--------------
--------------
--------------
--------------
--------------
--------------
-------SSS----
--------------
--------------
-E-E-E--------
XXXXXXXXXXXXXX
