--------------
--------------
--------------
--------------
--------------
----XXX------X
--------------
--------------
--------------
-X------------
--------------
--------------
--------------
XXX------XXXX-
