--------------
--------------
SSSSSSSSSSSSSS
--------------
--------------
---------oo---
--------------
-------SSS----
-----SoS---S--
-----SSS--SS--
--------------
--------------
--------EE----
XXXXXXXXXXXXXX
