--------------
--------------
--------------
--------------
--------------
--------------
--------------
--------------
--------------
------<-------
------[]-----<
------[]-----[
E-EE--[]-EE--[
XXXXXXXXXXXXXX
