--------------
--------------
--------------
--------------
--------------
---------SS---
--------------
--------------
--------------
--------------
--------------
--------------
-----------E--
XXXXXXXXXXXXXX
