--------------
--------------
--------------
--------------
--------------
--------------
--------------
--------------
--------------
--------X--X--
--XX-E-XX--XX-
-XXX<>-XX--XXX
XXXX[]-XX--XXX
XXXXXX--X--XXX
