--------------
--------------
--------------
--------------
--------------
--------------
--------------
--------------
-------E------
------<>------
------[]------
E-----[]------
Q--E--[]----E-
XXXXXXXXXXXXXX
