--------------
--------------
--------------
--------------
--------------
--------------
--------------
--------------
-------E------
------<>------
------[]------
------[]------
E-----[]------
XXXXXXXXX---XX
