--------------
--------------
--------------
--------------
--------------
--------------
-----XXX-----o
--------------
------------XX
E-------------
XXX-----------
--------------
--------------
--------------
