--------------
--------------
--------------
--------------
--------------
--------------
--------------
--------------
--------------
--------------
---------E----
--------------
--------------
XXXXXXXXXXXXXX
