--------------
--------------
--------------
--------------
--------------
---S----------
--------------
--------------
--------------
--------E-----
-------<>-----
-------[]-----
E----E-[]-----
XXXXXXXXXXXXXX
