--------------
--------------
SSSSSSSSSSSSSS
----SS--SSSSSS
----SS--SSSSSS
--SS------SSSS
--SS----------
--SS----------
--SS-----oo---
--SSSS---SSSSS
---SSS------SS
----SS--------
---E----------
XXXXXXXXXXXXXX
