--------------
--------------
SSSSSSSSSSSSSS
--------------
--------------
--------------
--------------
--------------
--------------
---E----E-----
--<>---<>-----
--[]---[]-----
--[]---[]-----
XXXX-XXXXXXXXX
