--------------
--------------
--------------
--------------
--------------
--------------
--------------
--------------
--------------
--------------
-----------E--
-----X----<>--
XEE--X----[]--
XXXXXXXXXXXXXX
