--------------
X-------------
--SSSSSSSSSSSS
--SSSSSS------
--SSSSSS------
--S--SSS--SS--
----------SS--
----------SS--
-----o----SSS-
---SSSSS--SS--
-------------E
--------------
--------------
-XXXXXXXXXXXXX
