--------------
--------------
--------------
--------------
--------------
--------------
--------------
--------------
--------------
--------------
-B-----E------
-b----<>------
-B----[]------
XXXXXXXXXXXXXX
