--------------
--------------
--------------
--------------
--------------
---------SSSSS
--------------
--------------
--------------
------S-------
--E-----------
-<>-----------
-[]-----------
XXXXXXXXXXXXXX
