--------------
--------------
--------------
--------------
--------------
--------------
-------------E
---------XXXXX
--------------
--------------
--------------
----XXXXX-----
--------------
--------------
