--------------
--------------
--------------
--------------
--------------
S-------------
--------------
--------------
S-------------
S-------------
--------------
--------------
--------------
XXXXXXXXXXX---
