--------------
--------------
--------------
--------------
--------------
--------------
----XXXXX-----
--------------
------------XX
XXX-----------
--------------
--------------
--------------
--------------
