--------------
--------------
--------------
-------------X
-------------X
---------S---X
-------------X
-------------X
-------------X
--------SS---X
-------------X
-------------X
-------------X
XXXXXXXXXXXXXX
