--------------
--------------
SSSSSSSSSSSSSS
--------------
--------------
--------------
--------------
------SSSSS---
-------SSSS---
-------SSSS---
XX------------
XXX-----------
XXX-----E-----
XXXXXXXXXXXXXX
