--------------
--------------
--------------
---XX---------
--------------
--------------
------XXX-----
X-------------
-----------X--
--------------
--------------
--------------
--------------
--XXXX-------X
