--------------
--------------
SSSSSSSSSSSSSS
--SSSSSSSS--S-
--SSSSSSSS----
---S---SS---SS
------------SS
--S----------S
----oo-SS---SS
---SSSSSS---SS
--------------
--------------
-------E------
--XXXXXXXXXXXX
