--------------
--------------
--------------
--------------
--------------
SSSS-SS-------
--------------
--------------
--------------
-----SSS------
--------------
--------------
--------------
XXXXXXXXXXX---
