--------------
--------------
--------------
--------------
-----------ooo
----------XXXX
--------------
--------------
--------------
--------------
------XXX-Q---
--------------
--------------
-X--------XXXX
