--------------
--------------
--------------
--------------
--------------
-----------X--
----------XX--
---------XX---
--------XXX---
-------XXXX---
------XXXXXX--
-----XXXXXX---
----XX-XXXX---
XXXXXXXXXXXXXX
