--------------
--------------
SSSSSSSSSSSSSS
-SSSSS------SS
--SSSS--------
---S----SS----
--------SS----
---S----SS---E
---So??-SS---E
---SSS--SS--SS
-----------E--
--------------
--------------
XXXXXXXXXXXXXX
