--------------
--------------
SSSSSSSSSSSSSS
----------SSSS
-----------SSS
--------------
--------------
------SS------
------SS------
----SSSS---SSS
--------------
X-------------
X------E------
X-XXXXXXXXXXXX
