--------------
--------------
--------------
--------------
--------------
----------XXoX
--------------
--------------
--------------
-----XXXX-----
--------------
--------------
--------------
XXXXX------XXX
