--------------
--------------
SSSSSSSSSSSSSS
--------------
--------------
---S--------QQ
-------S------
--------------
--------------
-SQS---SSS--SS
--------------
--------------
-----------E--
-XXX-XXXXXXXXX
