--------------
--------------
SSSSSSSSSSSSSS
--------------
--------------
------------oo
--------------
-----------SSS
-----------SoS
----------SSSS
--XX----------
-XXXXXX-------
XXX---X-------
XXX--X--XXXXXX
