--------------
--------------
--------------
--------------
--------------
-----------E--
-------------X
--------------
--------------
-------XXX----
--------------
--------------
--------------
--XXXXX-------
