--------------
--------------
--------------
--------------
--------------
--------------
--------------
--------------
--------------
--------------
--------XXX-?E
--------------
--------------
---XXXX-----XX
