--------------
--------------
--------------
--------------
--------------
--------------
--------------
--------------
--------------
-E------------
<>------------
[]------------
[]---------E--
XXXX--XXXXXXXX
