--------------
--------------
--------------
--------------
--------------
SS---------QQ-
--------------
--------------
--------------
XX--------S?--
--------------
--------------
--------------
----XXXXXXXXXX
