--------------
--------------
SSSSSSSSSSSSSS
SSS-SSSSSSSSSS
SS--SSSSSSSSSS
SS--SS--SSSSSS
SS--SS--------
SS------------
SS---Soo--oooo
SS---SSSSSSSSS
--------------
--------------
-E--------E-E-
XXXXXXXXXXXXXX
