--------------
--------------
SSSSSSSSSSSSSS
--------------
--------------
---ooooo------
--------------
--SSSSSS------
---SSSSS------
--SS----------
--------------
--------------
--------------
-XXXXXXXXXXXXX
