--------------
--------------
--------------
--------------
--------------
--------------
--------------
--------------
--------------
------S-----Q-
--------------
--------------
-------------E
X-XXXXXXXXXXXX
