--------------
--------------
SSSSSSSSSSSSSS
--------------
--------------
--------------
--------------
--------------
--E-----------
-<>-----------
-[]-----------
-[]-----------
-[]-----------
XXXXXX--XXX-XX
