--------------
--------------
-------SSSSSSS
S-------------
--------------
--------------
--------------
--------------
--------------
X-------------
X--XX---------
X--XXXX-------
X--XXXX---EE--
X--XXXXXXXXXXX
