--------------
--------------
--------------
--------------
--------------
--------Q-----
--------------
--------------
--------------
-------QQSQ---
--------------
--------------
--------------
XXXXXXXXXXXXXX
