--------------
--------------
--------------
XXXX----------
--------------
--------------
--------------
----XXXXXXX---
--------------
--------------
--------------
--------------
-------------o
-------------X
