--------------
--------------
--------------
--------------
--------------
--------------
--------------
--------------
--------------
----------E---
---------<>---
---------[]---
E-E------[]---
XXXXXXXXXXXXXX
