--------------
--------------
SSSS----SSSSSS
SSSS----------
SSSS----------
S-S----S------
--------------
--------------
--------------
SSSS----------
--------------
--------------
--------------
XXX-------XXXX
