--------------
--------------
--------------
--------------
--------------
--------------
--------------
--------------
--------------
---Q----------
--------------
--------------
-----------E-E
XXXXXX-XXXXXXX
