--------------
--------------
SSSSSSSSSS-S--
--------------
--------------
--------------
--------------
--------------
--------------
--------------
--------X-----
-------XXX----
---E---XXX----
XXXXXXXXX--XX-
