--------------
--------------
SSSSSSSSSSSSSS
--------------
--------------
--------------
--------------
--------------
--------------
----------E---
---------<>-E-
---------[]---
---------[]---
XXXXXXXXXXXXXX
