--------------
--------------
--------------
--------------
--------------
--------------
--------------
--------------
--------------
--------------
--------------
-------------X
------------XX
XXXXXXXXXXX-XX
