--------------
--------------
--------------
--------------
--------------
--------------
--------------
--------------
--------------
-E------------
<>------------
[]------------
[]-----E-E----
XXXXXXXXXXXXXX
