--------------
--------------
SSSSSSSSSSSSSS
--------------
--------------
-----------E--
----------<>--
----------[]--
----------[]--
--------SS[]--
----E-----[]--
---<>-----[]--
---[]--E--[]--
XXXXXXXXXXXXXX
