--------------
--------------
--------------
--------------
--------------
--------------
-----XX-------
------------XX
--------------
XXX-----X-----
--------------
-----------XXX
--------------
--------------
