--------------
--------------
--------------
--------------
--------------
--------------
--------------
--------------
--------------
---------QQQQ-
--------------
--------------
--------------
XXXXXXXXXXXXXX
