--------------
--------------
--------------
--------------
--------------
--------------
--------------
--------------
--------------
----------XXX-
----------XX--
--------XXXXX-
--E-----XXXX--
XXXXXXXXXXXX--
