--------------
--------------
--------------
--------------
-ooo------ooo-
-XXXX---------
--------------
--------------
--------------
--------------
--------------
--------------
--------------
XX----XXXXX--X
