--------------
--------------
--------------
--------------
--------------
--------------
--------------
--------------
--------------
--------------
-------E------
------<>------
------[]-E----
XXXXXXXXXXXXXX
