--------------
--------------
SSSSSSSSSSSSSS
--------------
--------------
--------------
-----E--------
----<>--------
----[]--------
----[]S----E--
----[]----<>--
----[]----[]--
-E--[]----[]--
XXXXXXX-XXXXXX
