--------------
--------------
o-------------
--------------
--------------
X-------------
--------------
--------------
--------------
--XXXX--------
--------------
--------------
--------------
XX------XXXXX-
