--------------
--------------
--------------
--------------
--------------
--------------
--------------
----------XXXX
--------------
-----XXXX-----
--------------
----------XXXX
--------------
--------------
