--------------
--------------
--------------
--------------
--------------
--------------
--------------
--------------
--------------
------Q-------
----E----E----
-------------X
------------XX
XXXXXXXXXXXXXX
