--------------
--------------
SSSSS------SSS
--------------
--------------
--------S-----
--------------
--------------
--------------
--------------
--XX--XXX-----
-XXXXX--------
XXXX----------
XXX----------X
