--------------
--------------
--------------
--------------
--------------
--------------
--------------
--------------
---SSSS-------
--------------
--------------
--------------
--------------
-X-XXXXXXXXXXX
