--------------
--------------
--------------
--------------
--------------
---XXXX-------
--------------
--------------
-------XXXX---
-------------E
--------------
------------X-
--------------
--------------
