--------------
--------------
SSSSSSSSSSSSSS
----SSSS------
----SSSS------
----SSS-------
----SS--------
-----------SS-
----SS-----SS-
----SSSS--SSSS
--------------
--------------
--------------
-XXXXXXXXXXXXX
