--------------
--------------
--------------
--------------
--------------
--------------
--------------
--------------
--------------
--------------
---------E----
X-------------
-----------E--
XXXXXXXXXXXXXX
