--------------
--------------
SSSSSSSSSSSSSS
--------------
--------------
------ooooo---
--------------
-------S------
------SSSSS---
--------------
--------------
--------------
-------E-E----
----XXXXXXXXX-
