--------------
--------------
--------------
--------------
---------E----
-------SSS----
--------------
--------------
--------------
-----SSSSS----
---------S----
--------------
--------------
X--XXXXX--XXXX
