--------------
--------------
--------------
--------------
--------------
--------------
--------------
--------------
--------------
-E------------
<>----E-------
[]------------
[]---------E--
XXXXXXXXXXXXXX
