--------------
--------------
SSSSSSSSSSSSSS
--SSSSSSSSSSSS
--SSSSSSSSSSSS
--SSSSSSSSSSSS
--------------
--------------
--------?----E
----SSSSSSSSSS
----SSSS--SSSS
----SSSS--SSSS
--------ooSSSS
---XXXXXXXXXXX
