--------------
--------------
--------------
--------------
--------------
--------------
--------------
--------------
--------------
------------S-
--------<>----
--------[]----
E-------[]----
XXXXXXXXXXXXXX
