--------------
--------------
--oo----------
--XX----------
--------------
--------------
--------------
--------------
--------------
X-------------
--------------
---XX---------
-----------E--
-------XXXXXXX
