--------------
--------------
--------------
--------------
--------------
--------------
--------------
--------------
--------------
--------------
--------------
-------X------
--EE---X-----E
XXXX-----XXXXX
