--------------
--------------
SSSSSSSSSSSSSS
--------------
--------------
--------------
--------------
--------------
---------E----
-----E--<>----
----<>--[]----
----[]--[]----
----[]--[]----
XXXXXXXXXX--XX
