--------------
--------------
SSSSSSSSSSSSSS
------SSSSSSSS
------SSSSSSSS
------SSSSSSSS
------S-------
------S-------
-------?oooooo
-------?--SSSS
--------------
--------------
-------------E
-------XXXXXXX
