--------------
--------------
--------------
--------------
--------------
--------------
---o----------
--------------
--------------
--------------
-------XXXX---
--------------
--------------
---XXX------XX
