--------------
--------------
SSSSSSSSSSSSSS
--------------
--------------
--------------
--------------
--------------
--------------
--------------
------X-------
-----XXXX-----
-----XX-------
XXXXXXX--XXX-X
