--------------
--------------
SSSSSSSSSSSSSS
--------------
--------------
--------------
--------------
--------------
------------SS
-----E--SS--SS
----<>--------
----[]--------
----[]--------
XXXXXXXXXXXXXX
