--------------
--------------
--------------
--------------
--------------
-----XXX------
-----XX-------
---XXXXX------
--XXXXXX------
--XXXXX-------
XXXXXXXX------
XXXXXXXX------
XXXXXXXX------
XXXXXXXXXXXXXX
