--------------
--------------
--------------
--------------
--------------
--------------
--------------
--------------
--------------
--------------
E-------------
>-------------
--------------
XXXX-XXXXX-XXX
