--------------
--------------
--------------
--------------
--------------
--------------
--------------
--------------
--------------
Q------------X
-------------X
-----------XXX
E---------XXXX
XXXXXXXXXXXXXX
