--------------
--------------
--------------
--------------
--------------
--E-----------
-<>-----------
-[]-----------
-[]-----------
-XX-------X---
--------------
----B----XX---
-----Q---XX---
XXXXXXXXXXXXXX
