--------------
--------------
--------------
--------------
--------------
--------Q-----
--------------
--------------
--------------
-----E--------
----<>--------
----[]--------
----[]------E-
XXXXXXXXXXXXXX
