--------------
--------------
-SSSSSSSSSSSSS
--------------
--------------
--------------
--------------
--------------
--------------
--------------
--------------
--------------
--------------
XXXXXXX-XXXXXX
