--------------
--------------
---------SSSS-
--------------
--------------
--------------
--------------
X-------------
--------------
--------------
--XXX---------
--------------
-----------E--
------XXXXXXXX
