--------------
--------------
--------------
--------------
--------------
--------------
--------------
-XS-----------
XX------------
XX------------
XXX-----------
XXX---S-------
XXX-----------
XX-------XXXXX
