--------------
--------------
--------------
--------------
--------------
--------------
--------------
--------------
--------------
--------------
--------------
--------------
--E-----E-E---
XXXXXXXXXXXXXX
