--------------
--------------
--------------
--------------
--------------
--------------
--------------
--------------
--------------
--------------
--------------
--------------
------EEE-----
XXXXXXXXXXXXXX
