--------------
--------------
--------------
--------------
--------------
--------------
--------------
--------------
--------------
-----------E--
---E------<>--
--<>------[]--
--[]------[]--
XXXXXXXXXXXXXX
