--------------
--------------
SSSSSSSSSSSSSS
--------------
--------------
--------------
--------------
--------------
--------------
------QQQ-Q---
--------------
--------------
----------E---
-XXXXXXXXXXXXX
