--------------
--------------
SSSSSSSSSSSSSS
----SS--SSSS--
----SS--SSS---
---S----------
--SS----------
--SS----------
--SS-----o-Q--
--SSSS--SSSS--
----SS--------
----SS--------
---E----------
XXXXXXXXXXXXXX
