--------------
--------------
--------------
--------------
--------------
SSSS----------
--------------
--------------
E-------------
SSSS----------
--------------
-----X--------
--------------
XXXXXXXXXXXXXX
