--------------
--------------
--------------
--------------
--------------
--------------
--------------
--------------
--------------
XXXXX-------EE
---------XXXX-
--------------
--------------
-------X------
