--------------
--------------
--------------
--------------
--------------
----------E---
---------XXX--
--------------
--------------
--XXXX-------X
--------------
--------------
--------------
XXX-----------
