--------------
--------------
--------------
--------------
--------------
--------------
--------------
X----------XXX
--------------
--------------
------XXXXXX--
--------------
--------------
-XXXX---------
