--------------
--------------
--------------
--------------
--------------
--------------
--------------
-------------X
------------XX
-----------XXX
----------XXXX
---------XXXXX
--------XXXXXX
XXXXXXXXXXXXXX
