--------------
--------------
-SSSSSSSSSSSSS
--------------
--------------
--------------
--------------
--------------
--------------
-----E-----E--
----<>----<>--
----[]----[]--
----[]-E--[]--
XXXXXXXXXXXXXX
