--------------
--------------
--------------
--------------
---o----------
--XXXX--------
--------------
--------------
--------------
XXXXXXX-------
--------------
--------------
--------X-----
--------------
