--------------
--------------
--------------
--------------
--------------
--------------
XXXX----------
--------------
-------XXX----
--------------
--------------
---XXXX-------
--------------
--------------
