--------------
--------------
--------------
--------------
--------------
--------XX----
--------XX----
--------XX----
-----X--XX----
-----X--XX----
---XXX--XX----
---XXX--X-----
-XXXXX--------
XXXXXXXXXXXXXX
