--------------
--------------
--------------
--------------
--------------
--------------
--------------
--------------
--------------
E-------E-----
>------<>-----
]------[]-----
]------[]-----
XXXXXXXXXXXXXX
