--------------
--------------
--------------
--------------
--------------
--------------
--------------
--------------
---------E----
--------<>----
--------[]----
--------[]----
-E------[]----
XXXXXXXXXXX--X
