--------------
--------------
--------------
--------------
--------------
--------------
--------------
--------------
--------------
--------------
-------B------
--X----b-----B
--X----B-----b
XXXXXXXXXXXXXX
