--------------
--------------
--------------
--------------
--------------
--------------
--------------
--------------
--------------
----------E---
---------<>---
---------[]---
-----EE--[]E--
XXXXXXXXXXXXXX
