--------------
--------------
--------------
--------------
--o-----------
--------------
--------------
--------------
--------------
---------E--S-
--------<>----
--------[]----
-E-E-E--[]-E--
XXXXXXXXXXXXXX
