--------------
----------X---
----SSSSSS--SS
------------SS
------------SS
---S--------SS
------------SS
--------------
--------------
--------------
--------------
-----XXXX-----
-----XX-------
XXXX---------X
