--------------
--------------
--------------
--------------
--------------
-----SSSSS----
--------------
--------------
--------------
-----SSSSS----
--------------
------------X-
------------X-
XXXXXXXXXXXXXX
