--------------
--------------
--------------
--------------
--------------
--------------
--------------
--------------
--------------
--------------
-------------E
XX------------
X-------------
--XXXXXXXXXXXX
