--------------
--------------
--------------
--------------
---XXXX-------
--------------
--------------
--------------
--------------
--------XXXXX-
--------------
--------------
--------------
----XXXX------
