--------------
--------------
----------ooo-
-----------XXX
--------------
XXX-----------
--------------
--------------
--------------
--XXX----XXXXX
-------------X
--------------
------X-------
--------------
