--------------
--------------
--------------
--------------
--------------
--------------
--------------
--------------
--------------
-----XX-------
-----XXXX-----
---XXXXXX-----
--XXXXX-------
XXXXXXX------X
