--------------
--------------
--------------
--------------
--------------
--------------
--------------
--------------
-o------------
--------------
--------------
--------------
--------------
----XXXXXXXXXX
