--------------
--------------
--------------
--------------
--------------
--------------
--------------
--------------
--------------
--------SSSS--
--------------
--------------
--------------
XX-----XXXXXXX
