--------------
--------------
--------------
--------------
--------------
----XXXX-----X
--------------
--------------
--------------
-XXXXXXXX-----
--------------
----------XXX-
--------------
--------------
