--------------
--------------
--------------
--------------
--------------
------S-Q-----
--------------
--------------
--------------
------Q-Q-----
--------------
-------------X
----E------XXX
XXXXXXXXXXXXXX
