--------------
--------------
SSSSSSSSSSSSSS
--------------
--------------
--------------
--------------
--------------
-------------S
--------------
------XX------
-----XXXX-----
-----XXX------
XXXXXXX---XXXX
