--------------
--------------
-------------E
--------------
---ooo--------
--XXXXX-------
--------------
--------------
--------------
-------------X
XX------------
--------------
--------------
--XXXXX-XXXXXX
