--------------
--------------
SSSSSSSSSSSSSS
-----S--------
--------------
--SS----------
--SS----------
--SS----------
--SS----------
--S---------QQ
--------------
--------------
--------------
XXXXXXXXXXXXXX
