--------------
X-------------
--SSSSSSSSSSSS
--SSSSSSSSSSSS
--SSSSSSSSSSSS
--SSSSSSSSSSSS
--SS----------
--------------
----oo--------
---??-SSSSSSSS
----------SSSS
X---------SSSS
----------SSSS
--XXXXXXXXXXXX
