--------------
--------------
SSSSSS-SSSSSSS
--------SSSSSS
--------SSSSSS
--------SSSSSS
---------S----
--------S-----
----------ooo-
---------??SSS
--X-----------
--XXXX--------
-XX-----------
-XX-----XXXXXX
