--------------
--------------
--------------
--------------
--------------
--------------
--------------
--------------
--------------
--------------
--------------
------X-------
-------------E
XXXXXXXX-XX-X-
