--------------
--------------
--------------
--------------
--------------
--------------
-o------------
--------------
-------------E
---XX----XXXX-
--------------
--------------
--------------
-----XXXX-----
