--------------
--------------
-----------o--
---------XXXXX
--------------
--------------
--------------
-------------X
--------------
---X----------
--------------
----------X-X-
--------------
--------------
