--------------
--------------
--------------
--------------
--------------
--------------
--------------
--------------
---------o----
--------------
--------------
--------------
--------------
XXXXXXXX---XXX
