--------------
--------------
--------------
--------------
--------------
--------------
--------------
--------------
--------E-----
-------<>-----
-------[]-----
-------[]-----
-----E-[]-----
XXXXXXXXXXXXXX
