--------------
--------------
--------------
--------------
--------------
--------------
--------------
--------------
--------------
--------------
-----E--------
--------------
--------------
-XXXXXXXXXX---
