--------------
--------------
SSSSSSSSSSSSSS
--SS--SSSS----
--SS--SSSS----
SSS----S------
SS------------
SS------------
SS------------
SSSS--SSSSQ-Q-
--SS----------
--SS----------
--------------
XXXXXXXXXXXXX-
