--------------
--------------
SSSSS--SSSSSSS
--------------
--------------
--------------
--------------
--------------
-------------S
------XXXX---S
---XXXX-------
XXXXXX--------
XXXX----------
XXX-----XX--XX
