--------------
--------------
--------------
--------------
--------------
------------Q-
--------------
--------------
--------------
-----------SSS
--------------
--------------
-E------------
XXXXXXXXXXXXXX
