--------------
--------------
SSSSS---SSSSSS
--------SSSSSS
---------SSSSS
--------SSSSSS
--------------
--------------
----------oooo
----------?SSS
--XX----------
-XXXXXX-------
XXXX----------
XXX-------XXXX
