--------------
--------------
--------------
--------------
--------------
--------------
--------------
--------------
--------------
---------X-XXX
--------XX-XXX
-------XXXXXXX
------XXX----X
XXXXXXXXXXXX-X
