--------------
--------------
SSSSSSSSSSSSSS
--SSSS------SS
--SSSS--------
----------oo-o
--------------
----------SS--
---E------SSSS
--SSSS-------S
-E------------
--------------
--------------
XXXXXX---XXXXX
