--------------
--------------
--------------
--------------
--------------
--------------
--------------
--------------
--------------
-------------E
------------<>
------------[]
-E----------[]
XXXXXXXXXXXXXX
