--------------
--------------
--------------
----E---------
----XXXXXXX---
--------------
--------------
--------------
-XX-----------
--------------
--------------
--------------
--------------
--------------
