--------------
--------------
--------------
--------------
--------------
--------------
--------------
--------------
--E-----------
-<>---S-------
-[]-----------
-[]-----------
-[]-----------
XXXXXXXXXXXXX-
