--------------
--------------
SSSSSSSSSSSSSS
--------SSSSSS
--------SSSSSS
--------SSSSSS
--------S-----
--------------
---------ooooo
-----------SS-
-XXX----------
-XXX-X--------
XXXX----------
XXX-----XXXXXX
