--------------
--------------
--------------
--------------
--------------
SS------------
--------------
--------------
--------------
SSS-----------
-------------<
-------------[
-------------[
XXXXXXXXXXXXXX
