--------------
--------------
--------------
X-------------
--------------
--------------
--XXX---------
---------XX---
--------------
--------------
--------------
--------------
-------------E
X-------XXXXX-
