--------------
--------------
--------------
--------------
--------------
--------------
--------------
--------------
--E--------E--
-<>-------<>--
-[]-------[]--
-[]-------[]--
-[]-------[]--
XXXXXXXXXXXXXX
