--------------
--------------
--------------
--------------
--------------
--------------
--------------
--------------
--------------
--------------
-----E------E-
----<>-----<>-
--E-[]-----[]-
XXXXXXXXXXXXXX
