--------------
--------------
SSSSSSSSSSSSSS
--------------
--------------
--------------
-------------E
--------------
--------------
--------------
-------------E
------------<>
EE-E--E-----[]
XXXXXXXXXXXXXX
