--------------
--------------
--------------
--------------
--------------
--------------
--------------
--------------
--------------
--------------
--------------
--------------
-EE-------E---
XXXXXXXXXXXXXX
