--------------
--------------
--------------
--------------
--------------
--------------
--------------
--------------
--------------
--------E-----
-------<>-----
-------[]-----
-------[]-E---
XXXXXXXXXXXXXX
