--------------
--------------
-SSSSSSSSSSSSS
--------------
--------------
--------------
---XX---------
--------------
--E-----------
--------------
--------------
------------E-
--------------
---XXXXXX-XX--
