--------------
--------------
--------------
--------------
--------------
-Q------------
--------------
--------------
--------------
-Q--Q--------S
--------------
--------------
--------------
XXXXXXXXXXX--X
