--------------
--------------
SSSSSSSSSSSSSS
--------------
--------------
--------------
--------------
--------------
-------SS-----
-------SSS----
--------------
XXX-----------
XX----E-------
XXXXXXXXXXXX-X
