--------------
--------------
--------------
--------------
--------------
--------------
--------------
--------------
----E---------
---<>----E---S
---[]---<>----
---[]---[]----
---[]---[]----
XXXXXXXXXXXXXX
