--------------
--------------
--------------
--------------
--------------
----------SSSS
--------------
--------------
--------------
--------------
-<>-----------
-[]-----------
-[]--------E-E
XXXXXXXXXXXXXX
