--------------
--------------
SSSSSSSSSSSSSS
--------SSSSSS
--------SSSSSS
--------SSSSSS
--------------
--------------
--------------
----------SSSS
----------SSSS
----------SSSS
--------------
-X---X----XXXX
