--------------
--------------
----ooo-------
----XXXX------
--------------
--------------
--------------
--------------
---------XXX--
-XX-----------
----XXXXXX----
----XXXXX-----
--------------
--------------
