--------------
--------------
--------------
--------------
--------------
---------SS---
--------------
--------------
--------------
--------------
----E---------
--------------
----------E---
XXXXXXXXXXXXXX
