--------------
--------------
SSSSSSSSSSSSSS
------SSSS----
--------SS----
-------S------
--------------
--------------
--------------
------SSSS----
------E-------
--------------
--------------
-XX-XXXXXX----
