--------------
--------------
--------------
--------------
--------------
-----SSS------
--------------
--------------
--------------
----X---------
--------------
----X---------
-E--------E---
XXXXXXXXXXXXXX
