--------------
--------------
SSSSSSSSSSSSSS
-S------SSSSSS
--------SSSSSS
----SS--SS--SS
----S----S----
----SS--------
----SS---Soo--
----SS---SSSSS
--------------
--------------
--------------
-XXXXXXXXXXXXX
