--------------
--------------
SSSSSSSSSSSSSS
--------------
--------------
--------------
--o-----------
--------------
--------------
X-------------
X--XX---------
X--XXXX-------
XE-XXXX----E--
X-XXXXXXXXXXXX
