--------------
--------------
--------------
--------------
--------------
--------------
--------------
--------------
--------------
--------------
--------------
-------------X
---------E--XX
X----XXXXXXXXX
