--------------
--------------
--------------
--------------
--------------
--------------
--------------
--------------
--------------
----XXXX------
--------------
--------------
--------------
XXXXXX-XX----X
