--------------
--------------
--------------
--------------
--------------
----SSSS------
--------------
--------------
--------------
-----SSS-----E
------------<>
------------[]
------------[]
XXXXXXXXXXXXXX
