--------------
--------------
SSSSSSSSSSSSSS
--------------
--------------
--------------
-------E------
------<>------
------[]------
E---SS[]SS---E
-E----[]----<>
<>----[]----[]
[]----[]----[]
XXXXXXXXXXXXXX
