--------------
--------------
--------------
--------------
--------------
--------------
--------------
--------------
--------------
-X------------
XX---X------E-
XX---XX----<>-
XX---XX----[]-
X-X-XXXXXXXXXX
