--------------
--------------
SSSSSSSSSSSSSS
--------------
--------------
--------------
--------------
--------------
--------------
Q--------X----
-------XXX----
-----XXXXX----
E---XXXXXX----
XXXXXXXXXX--XX
