--------------
--------------
SSSSSSSSSSSSSS
--------------
--------------
--------------
--------------
--------------
-----E--------
----<>-----E--
----[]----<>--
----[]----[]--
-E--[]----[]--
-XXXXXXXXXXXXX
