--------------
--------------
--------------
--------------
--------------
--------------
--------------
--------------
--------------
---------SSS--
--------------
--------------
--------------
XXXXXXXXXXXXXX
