--------------
--------------
--------------
--------------
--------------
--------------
--------------
--------------
---------oo---
--------------
--------------
--------------
--------------
--X-XXXXXXXXXX
