--------------
--------------
SSSSSSSSSSSSSS
--------------
--------------
--------------
--------------
--------------
--------------
<>----E-------
[]---<>-------
[]---[]-------
[]---[]-------
XXXXXXXXXXXX-X
