--------------
--------------
--------------
--------------
--------------
--------------
--------------
--------------
--------------
------E-------
-----<>-------
-----[]----B--
-----[]----b--
XXXXXXXXXXXXXX
