--------------
--------------
--------------
--------------
--------------
--------SS----
--------------
--------------
--------------
-------SS-----
------------X-
------------X-
------------X-
XXXXXXXXXXXXXX
