--------------
--------------
--------------
--------------
--------------
--------------
--------------
--------------
--------------
---Q----------
----------XXXX
---------XXXXX
-------XXXXX--
XXXXXXXXXXX---
