--------------
--------------
SSSSSSSSSSSSSS
------SSSSSSSS
------SSSSSSSS
------SSSSSSSS
------S-------
--------------
--------------
-------?SSSS??
--------SSSS--
---------S----
-------E-----o
X------XXXXXXX
