--------------
--------------
--------------
--------------
--------------
--------------
--------------
--------------
--------------
----E------EE-
---<>-----<>>-
---[]-----[]]-
---[]-----[]--
XXXXXXXX--XXXX
