--------------
--------------
--------------
--------------
--------------
-----XX-------
-----XX-------
----XXX-------
---XXXX-------
--X-XXX-------
-XXX-XX-------
-XXX-XX-------
-XXX-XX-----E-
XXXXXXXXXXXXXX
