--------------
--------------
--------------
--------------
--------------
--------------
--------------
-------------X
--------------
---XXX--------
--------------
-------XXXX---
--------------
XX------------
