--------------
--------------
--------------
--------------
---o----------
-XXXXXX-------
--------------
--------------
-------------X
XXXXXXXX------
--------------
---------XXX--
--------------
--------------
