--------------
--------------
--------------
--------------
--------------
--------------
--------------
--------------
--------SSSSSS
--------------
--------------
--------------
---EE---------
XXXXXXXXXXXXXX
