--------------
--------------
--------------
--------------
--------------
-----SSQS-----
--------------
--------------
--------------
-QQS--QQS-----
--------------
--------------
---------E-EE-
XXXXXXXXXXXXXX
