--------------
--------------
SSSSSSSSSSSSSS
SS------------
SS------------
SS------------
--------------
--------------
--------------
---------QQ---
--------------
--------------
-----------E--
XX---XXXXXXX-X
