--------------
--------------
SSSSSSSSSSSSSS
--------------
--------------
--------------
--------------
--------------
--------------
--------------
--SS----------
--SS---------E
--SS----------
--XX--XXXXXXXX
