--------------
--------------
--------------
--------------
--------------
--------------
--------------
-------------E
--------------
---SSS-----E-E
---------E<><>
--------<>[][]
--------[][][]
---XXXXXXXXXXX
