--------------
--------------
SSSSSSSSSSSS--
--------------
--------------
--------------
--------------
--------------
--------------
--------------
----XX---X-XXX
-EXXXX--------
--XXXX--------
XX------------
