--------------
--------------
SSSSSSSSSSSSSS
SSSSSSSS------
SSSSSSSSS-----
SSSSSSSS------
--------------
--------------
oooo----------
SSSSSS----XX--
---------XXX--
-------XXXXX--
E-E----XXXXX--
XXXXXXXXXXXXXX
