--------------
--------------
--------------
--------------
--------------
--------------
--------------
--------------
--------------
----EX--------
---XXX--------
--XXXX--------
XXXXXX----EE--
XXXXXXXXXXXXXX
