--------------
--------------
--------------
--------------
-----XX-------
--------------
-----XX-------
-----XX-------
-----XX-------
-----XX-------
-----XX-------
-----XX-------
------X-------
XXXXXXXX-XXXXX
