--------------
--------------
SSSSSSSSSSSSSS
--------------
--------------
--------------
--------------
--------------
--------------
--------------
-----------XX-
---------XXXXX
--------XXXX--
-XXXXXXXXX-X--
