--------------
--------------
--------------
--------------
--------------
--------------
--------------
--------------
------E-------
-----<>-------
-----[]-------
-----[]-------
--E--[]-------
XXXXXXXXXXXXXX
