--------------
--------------
--------------
--------------
--------------
XX------------
--------------
--------------
---XXXX-------
--------------
--------------
--------------
--------------
------XXXXXXXX
