--------------
--------------
SSSSSSSSSSSSSS
--------------
--------------
--------------
--------------
--------------
--------------
---E------E---
--<>-----<>---
--[]-----[]---
--[]-----[]E--
XXXX--XXXXXXXX
