--------------
--------------
--------------
--------------
--------------
--------------
--------------
--------------
--------------
-------E------
------<>------
------[]------
E-E---[]------
XXXXXXXXXXXXXX
