--------------
--------------
--------------
--------------
--------------
--------------
--------------
--------------
--------------
XXXX----------
X-------------
--------------
--------------
-------XXXXXXX
