--------------
--------------
--------------
--------------
--------------
-----SSSSS----
--------------
--------------
------E-------
Q-----SSSS----
--------------
------------XX
------------X-
XXXXXXXXXXXXXX
