--------------
--------------
--------------
--------------
--------------
--------------
--------------
--------------
--------------
--------------
--------------
--------------
--E-E------EEE
XXXXXXXXXXXXXX
