--------------
--------------
--------------
--------------
--------------
--------------
--------------
--------------
-------E------
------<>------
------[]------
------[]------
------[]----E-
-XXXXXXXXXXXXX
