--------------
--------------
SSSSSSSSSSSSS-
SSSS----------
SSSS----------
SSSS--Q-------
--------------
--------------
E-------------
SSSS--QQ--QQQ-
SSSS----------
SSSS----------
SSSS----------
XXXX-XXXXXXXXX
