--------------
--------------
--------------
--------------
--------------
--------------
--------------
--------------
--------------
--------S-----
--------------
--------------
--------------
XXXXXXXXXXXXXX
