--------------
--------------
--------------
--------------
--------------
--------------
----XXXX------
--------------
-----------XXX
XXXX----------
--------------
------XXXXX---
--------------
--------------
