--------------
--------------
--------------
--------------
--------------
SSSSSSSSS-----
--------------
--------------
--------------
--------------
------------E-
-----------<>-
-----------[]-
XXXXXXXXXXXXXX
