--------------
--------------
--------------
--------------
--------------
SSS-----------
--------------
-------------X
------------XX
--SSS------XXX
----------XXXX
---------XXXXX
---------X-XXX
---XXXXXXXXXXX
