--------------
--------------
--------------
--------------
--------------
----Q---------
--------------
--------------
--------------
---QQQ--------
--------------
--------------
--------------
XXXXXXXXXXX-XX
