--------------
--------------
--------------
--------------
--------------
SSSS----------
--------------
--------------
--E-----------
-<>-----------
-[]-----------
-[]-----------
-[]---------EE
XXXXXXXXXXXXXX
