--------------
--------------
SSSSSSSSSSSSSS
--------------
--------------
--------------
-----------E--
----------<>--
----------[]--
---------S[]SS
----------[]--
--XXXX----[]--
-XXXXXXE--[]--
XXXXXXXXXXXXXX
