--------------
--------------
--------------
--------------
--------------
-------SSSSSSS
--------------
--------------
--------------
--------------
--------------
--------------
--------------
XXXXXXXX------
