--------------
--------------
SSSSSSSSSSSSSS
--SSSSSSSSSSSS
--SSSSSSSSSSSS
--SSSSSSSSSSSS
--SS----------
--S-----------
---?ooooooooo-
---??SSSSSSSSS
--------------
--------------
---------EE---
--XXXXXXXXXXXX
