--------------
--------------
--------------
--------------
--------------
-----------SSS
--------------
--------------
--------------
----------XXXX
-----E----XX--
----<>----X---
----[]----X---
XXXXXXXXXXXXXX
