--------------
--------------
--------------
--------------
--------------
--------------
--------------
--------------
--------------
--------------
-------------<
-------------[
----------E--[
XXXXXXXXXXXXXX
