--------------
--------------
--------------
--------------
--------------
-----SSSSSSSSS
--------------
--------------
--------------
--------------
--------------
--------------
--E-----------
XXXXXXXXXX----
