--------------
--------------
--------------
--------------
--------------
--------------
--------------
--------------
--------E-----
-------<>----E
-------[]-----
-------[]-----
E------[]-----
XXXXXXXXXXXXXX
