--------------
--------------
--------------
--------------
--------------
--------------
--------------
--------------
--------------
-----XX-------
--------------
--------------
--------------
XX------XXXXXX
