--------------
--------------
----------o---
--------------
o------------X
--------------
--------------
--------------
--------XXXXX-
XXX-----------
--------------
----XXX-------
--------------
--------------
