--------------
--------------
--------------
--------------
--------------
--------------
--------------
--------------
--------------
----------XXXX
--------------
--------------
--------------
----XXXXXXX--X
