--------------
--------------
--------------
--------------
--------------
--------------
--------------
--------------
--S-----------
--------------
--------------
--------------
--------------
-XXXXXXXXXXXXX
