--------------
--------------
--------------
--------------
--------------
--------------
--------------
--------------
--------------
-------------X
------------XX
-----------XXX
----------XXX-
XX-XXXXXXXXXXX
