--------------
--------------
--------------
--------------
--------------
--------------
--------------
--------------
--------------
--------------
---X----------
---X----------
---X-E--------
XXXXXXXXXXXXXX
