--------------
--------------
--------------
--------------
--------------
--------------
-----X--------
--------------
--------------
XXX-----------
--------------
--------------
--------------
------XXXXXXXX
