--------------
--------------
--------------
--------------
--------------
--------------
--------------
--------------
-------------E
------------<>
-<>---------[]
-[]---------[]
-[]---------[]
XXXXXXXXXXXXXX
