--------------
--------------
--------------
--------------
--------------
XXXXXX--------
--------------
--------------
--------------
XXXXXXX-------
--------------
--------------
-------XXX----
--------------
