--------------
--------------
SSSSSSSSSSSSSS
SSSSSSSSSSSSS-
SSSSSSSSSSSSS-
SSSSSSSSSSSSS-
--------------
--------------
----?----E----
SSSS??SSSSSSS-
SSSS--SSSSSS--
SSS---SSSSSS--
----oo--SSS---
XXXXXXXXXXXXXX
