--------------
--------------
SSSSSSSSSSSSSS
--SSSSS-------
---SSS--------
--SSS---------
---S----------
--------------
--------------
--------------
-------XXXX---
------XXXX----
-----XXXXX----
X-XXXXXX------
