--------------
--------------
--------------
--------------
--------------
----------SSSS
--------------
--------------
-------X------
------E----S--
----XXXX------
---XXXXX------
--XXXXXX------
XXXXXXXXXXXXXX
