--------------
--------------
SSSSSSSSS-----
--------------
--------------
--------------
--------------
--------------
--------------
-------------X
---E----X-X-XX
---XXXXXXXX---
-XXXXXXXX-----
XXXXXX--------
