--------------
--------------
-SSSSSSSSSSSSS
--------------
--------------
--------------
--------------
--------------
--------------
--------------
--------------
XXXX----------
--------------
--------------
