--------------
--------------
--------------
--------------
--------------
SSS-----------
--------------
--------------
------E-------
-----<>-------
-----[]-------
-----[]-------
-----[]-------
XXXXXXXXXXXXXX
