--------------
--------------
--------------
--------------
--------------
--------------
--------------
--------------
-------------S
--------------
--------------
--------------
--------------
XXXXXXXXXXXXXX
