--------------
--------------
--------------
--------------
--------------
--------------
--------------
--------------
-----------o--
--------E-----
-------<>-----
-------[]-----
----E--[]-----
XXXXXXXXXXXXXX
