--------------
--------------
SSSSSSSSSSSSSS
--------------
--------------
--------------
--------------
--------------
---E----------
--<>----E-----
--[]---<>----<
--[]---[]----[
--[]---[]----[
XXXXXXXXXXXXXX
