--------------
--------------
--------------
--------------
--------------
--------------
-----E--------
--------------
--------------
Q------------E
>----B-----<>-
]----b-----[]-
]----------[]-
XXXXXXXXXXXXXX
