--------------
--------------
--------------
--------------
--------------
--------------
--------------
--------------
--------------
--------------
--------------
--------------
----E-EEE----E
XXXXXXXXXXXXXX
