--------------
--------------
--------------
--------------
--------------
SSSSS----SSSS-
--------------
--------------
--------------
--------------
--------------
--------------
-E-E-E--------
XXXXXXXXXXX---
