--------------
--------------
--------------
--------------
--------------
--------------
--------------
--------------
--------------
--------------
--------------
--------------
-------E--XXEE
XXXXXXXXXXXX-X
