--------------
--------------
--------------
--------------
--------------
--------------
--------------
--------------
--------------
--------------
---------E----
--------<>----
--------[]----
XX----XXXXXXXX
