--------------
--------------
SSSSSSSSSSSSSS
--------------
--------------
--------------
--------------
--------------
--------------
--------------
----------E---
---------<>---
---E-----[]---
XXXXXXXXXXXXXX
