--------------
--------------
--------------
--------------
--------------
-----XXX------
-----XX-------
---XXXX-------
---XXX--------
-XXXXXX------E
-XX-XXX-----<>
-XXXXXX-----[]
--X-XXX-----[]
XXXXXXXXXXXXXX
