--------------
--------------
--------------
--------------
--------------
--------------
--------------
--------------
--------------
--------------
--------------
XX------------
X------E-E----
XXXXXXXXXXXXX-
