--------------
--------------
--------------
--------------
--------------
--------------
--------------
--------------
--------------
-SSS----------
--------------
--------------
--------------
XXXXXXXXXXXXXX
