--------------
--------------
--------------
--------------
--------------
--------------
--------------
--------------
-E------------
<>------------
[]------------
[]------------
[]-------EE---
XXXXXXXXXXXXXX
