--------------
--------------
--------------
--------------
--------------
--------------
--------------
--------------
--------------
--------------
--------------
-------B------
--------------
XXX-XXXXXXXXXX
