--------------
--------------
--------------
--------------
--------------
-------S------
--------------
--------------
--------------
------SSS-----
-------------X
-------------X
----------XXXX
XXXXXXXXXXXXXX
