--------------
--------------
SSSSSSSSSSSSSS
--------------
--------------
--------------
--------------
--------------
--------------
--------------
--------X-----
-------XXX----
--E----XX-----
XXXXXXXXX--XXX
