--------------
--------------
--------------
--------------
--------------
--------------
--------------
--------------
--------------
------E-----X-
-----<>-------
-----[]-------
-----[]-------
XXXXXXXXXXXXXX
