--------------
--------------
--------------
--------------
--------------
--------------
--------------
--------------
--------------
--------------
--------------
--------------
E-E-----------
XXXXXXXXXXXXXX
