--------------
--------------
--SSSSSSS-SSSS
--------------
--------------
--------------
--------------
--------------
--------------
-----------QQ-
--------------
--------------
--------------
-X-XXXXXXXXXX-
