--------------
--------------
--------------
--------------
--------------
--------------
--------------
--------------
--------------
--------------
--------------
--------------
E-EE-E--------
XXXXXXXXXXXX-X
