--------------
--------------
--------------
--------------
--------------
--------------
--------------
--------------
-------------E
Q-----------<>
------------[]
------------[]
------------[]
XXXXXXXXXXXXXX
