--------------
--------------
--------------
--------------
XXX-----------
--------------
--------XXX---
--------------
--------------
--XXXXX-------
--------------
--------------
--------------
XX-----------X
