--------------
--------------
SSSSSSSSSSSSSS
SSSSSSSSSSSSSS
SSSSSSSSSSSSSS
SSSSSSSSSSSSSS
--------------
--------------
-------------E
SS??SSSSSSSSSS
----SSSSSSSSSS
----SSSSSSSSSS
-oo-SSSSSSSSSS
XXXXXXXXXXXXXX
