--------------
--------------
--------------
--------------
--------------
--------------
--------------
--------------
--------------
--------------
--------------
--------------
------E-E----E
--XXXXXXXXXX-X
