--------------
--------------
--------------
--------------
--------------
--------------
--------------
XXXXXXX-------
--------------
------------XX
--------------
--------------
----------oo--
---------XXX--
