--------------
--------------
--------------
--------------
--------------
--------------
--------------
--------------
--------------
--------------
------------X-
------------X-
------E--E--XX
XXXXXXXXXXXXXX
