--------------
--------------
--------------
--------------
--------------
--------------
--------------
--------------
--------------
-------QQS----
--------------
--------------
-------------E
X-XXXXXXXXXXXX
