--------------
--------------
SSSSSSSSSSSSSS
SSSS----------
SSSS----------
SSSS-----ooooo
--------------
---------SSSSS
----------SSSS
SSSS------SS-S
--SS----------
--------------
--------------
XXXX----XXXXXX
