--------------
--------------
--------------
--------------
--------------
--------------
--------------
--------------
--------------
--------------
------E-------
----<<>-------
----[[]-------
XXX-XXXXXXXXXX
