--------------
--------------
SSSSSSSSSSSSSS
--------------
--------------
--------------
--------------
--------------
--------------
---------QQ---
--------------
--------------
--------------
XX--XX--XXXXXX
