--------------
--------------
--------------
--------------
--------------
--------------
--------------
--------------
--------------
--------------
--------------
----X---------
------E---E-EE
XXXXXXXXXXXXXX
