--------------
--------------
--------------
--------------
--------------
--------------
--------------
--------------
--------------
--------------
-E------------
<>------------
[]----------EE
XXXXXXXXXXXXXX
