--------------
--------------
SSSSSSSSSSSSSS
--------------
--------------
-ooo----------
--------------
SSSS----------
--------------
--SSSSS-------
--------------
--------------
--------------
XXXXXXXXXXXXXX
