--------------
--------------
--------------
--------------
--------------
--------------
--------------
--------------
--------------
----------E---
---------<>---
---------[]---
---E--EE-[]---
XXXXXXXXXXXXXX
