--------------
--------------
--------------
--------------
--------------
--------------
--------------
--------------
--EE----------
----XX-X------
----XX-XX-----
----XX-XXX----
----X--XXX----
----X--XXXX---
