--------------
--------------
--------------
--------------
--------------
--------------
--------------
-------XXS----
------XXXSS---
-----XXXX-----
-----XXXX-----
---XXXXXXX--SS
---XX-XXX-----
XXXXXXXX------
