--------------
--------------
SSSSSSSSSSSSSS
S-----SS--SSSS
S-----SS--SSSS
----SS--------
----SS--------
----SS--------
----SS-----ooo
SS--SSSS--SSSS
------SS------
------SS------
-----E--------
XXXXXXXXXXXXXX
