--------------
--------------
--------------
--------------
--------------
--------------
--------------
--------------
--------------
--------------
--------------
-------<>-----
E-EEE--[]E----
XXXXXXXXXXXXXX
