--------------
--------------
--------------
--------------
----oo--------
---XXXXX------
--------------
--------------
-------------X
--------------
--------------
---------XXXX-
--------------
--------------
