--------------
--------------
--------------
--------------
--------------
--------------
o--------XX---
--------------
--------------
---XXXX------X
--------------
--------------
oo------------
XXX-----------
