--------------
--------------
--------------
--------------
--------------
--------------
--------------
--------------
--------------
--------------
--------------
-----B--------
-----b--------
XXXXXXXXXXXX--
