--------------
--------------
-SSSSSSS------
--------------
--------------
--------------
--------------
--------------
--------------
--Q----------X
--------------
------XXXXX---
------X-------
XXXXXXX------X
