--------------
--------------
SSSSSSSSSSSSSS
--------------
--------------
--------------
-----E--------
----<>--------
----[]--------
-E--[]--------
<>--[]--------
[]--[]--------
[]--[]--------
XXXXXX--XXXXXX
