--------------
--------------
SSSSSSSSSSSSSS
S-SS--SSSS----
---S--SSSS----
--SS---S----SS
--SS---S----SS
--SS---S----SS
o-SS---So??-SS
-SSS---SSS--SS
--------------
--------------
--------------
XXXXXXXXXXXXX-
