--------------
--------------
--------------
--------------
--------------
S-------SSSSS-
--------------
--------------
--------------
-----E--------
----<>--------
----[]--------
----[]--------
XXXXXXXXXX---X
