--------------
--------------
--------------
--------------
-----------oo-
--------------
--------------
--------------
-------------X
--------------
----XXXXXX----
--------------
--------------
XXX--------XX-
