--------------
--------------
--------------
--------------
--------------
--------------
--------------
--------------
--------------
-------Q-Q----
--------------
--------------
--------------
XXXXXXXXXXXXXX
