--------------
--------------
--------------
--------------
--------------
--------------
--------------
--------------
--------------
------------XX
--------------
XXX-----------
--------------
-----XXXXXX---
