--------------
--------------
--------------
--------------
--------------
--------------
----XX--------
--------------
-----------XXX
--------------
--------------
-------XXXX---
--------------
XXXX----------
