--------------
--------------
SSSSSSSSSSSSSS
--------------
--------------
--------------
--------------
--------------
--------------
--------------
------------XX
-----------XXX
---------XXXXX
----XXXXXXX---
