--------------
--------------
--------------
--------------
--------------
--------------
--------------
--------------
--------------
--------------
--------------
-XXX----------
-XX--------E--
-------XXXXXXX
