--------------
--------------
--------------
--------------
--------------
--------------
X------------X
------------XX
-----------XXX
---------XXXXX
---------XXXXX
---------XXXXX
-----E---XX-XX
XXXXXXXXXXXXXX
