--------------
--------------
--------------
--------------
o----o--------
--------------
--------------
--------X----E
--------------
-XX-----------
--------------
-----XXXXX----
--------------
--------------
