--------------
--------------
--------------
--------------
--------------
--------------
--------------
--------------
oo------------
--------------
--------------
--------------
----------E-EE
---XXXXXXXXXXX
