--------------
--------------
SSSSSSSSSSSSSS
--SSSSSSSSSSSS
--SSSSSSSSSSSS
--SSSSSSSSSSSS
--------------
--------------
----------E-EE
----SSSSSSSSSS
----SSSSSSSSSS
----SSSSSSSSSS
-----SSSSSSSS-
---XXXXXXXXXXX
