--------------
--------------
--------------
--------------
--------------
--------------
--------------
--------------
--------------
-------------E
------------<>
------------[]
---E--E-E---[]
-XXXXXXXXXXXXX
