--------------
--------------
SSSSSSSSSSSSSS
--------------
--------------
--------------
--------------
--------------
--------------
--------------
--------------
--------------
--------------
-XXXXX---XXXXX
