--------------
--------------
SSSSSSSSSSSSSS
SSSS----------
SSSS----------
SSSS----------
---------E----
--------<>----
--------[]----
--SS--SS[]----
-<>-----[]----
-[]-----[]----
-[------[]----
XXXXXXXXXXXXXX
