--------------
--------------
SSSSSSSSSSSSSS
SSSSSSSS------
SSSSSSSS------
SSSSSSSS------
--------------
--------------
--E-EE--------
SSSSSSSS--QQ--
SSSSSSSS------
SSSSSSSS------
SSSSSSSS------
XXXXXXXXXXXXXX
