--------------
--------------
--------------
--------------
--------------
--------------
--------------
----XXXXXX----
--------------
XXX-----------
--------------
--------------
-----------oo-
----------XXX-
