--------------
--------------
--------------
--------------
--------------
--------------
--------------
---------XXXXX
--------------
--------------
------XXX-----
--------------
--------------
-XXXX---------
