--------------
-------XX-----
SSSSSS--S-SSSS
SSSSS-----SSSS
SSS-------SSSS
SSS-------SSSS
----------S---
----------S---
------------oo
SS---------??S
--------------
---XXXXXX-----
----XX--------
-XXX------XXXX
