--------------
--------------
SSSSSSSSSSSSSS
--SSSSSSSSSSSS
--SSSSSSSSSSSS
--SSSSSSSSSSSS
--------------
--------------
----------E--E
----SSSSSSSSSS
----SSSSSSSSSS
----SSSSSSSSSS
-------SSSSSSS
---XXXXXXXXXXX
