--------------
--------------
--------------
--------------
--------------
--------------
--------------
-------------X
-------------X
-------------X
--------XXXX--
-------XXXXX--
------XXXX----
XXXXXXXXXX----
