--------------
--------------
--------------
--------------
--------------
----S------E--
----------<>--
----------[]--
----------[]--
----SS----X---
--------------
--------------
--------------
XXXXXXXXXXXXXX
