--------------
--------------
--------------
--------------
--------------
--------------
--------------
--------------
-------X--o---
S-----XX------
-----XXX------
----XXXX------
---XXX--------
XXXXXXXXXXXXXX
