--------------
--------------
--------------
--------------
--------------
---------SS---
--------------
--------------
--------------
--------------
---------B----
---------b----
---------B----
XXXXXXXXXXXXXX
