--------------
--------------
SSSSSSSSSSSSSS
---SSSSSSS----
---SSSSSSS----
--SSSSSSSS----
--------------
--------------
--------------
----SS-----X--
---------XXX--
---------XXXX-
-------XXXXX--
--XXXXXXXXXXXX
