--------------
--------------
--------------
--------------
--------------
--------------
--------------
--------------
--------------
---E----------
--<>----------
--[]----------
--[]----------
XXXXXXXXXXXXXX
