--------------
--------------
SSSSSSSSSSSSSS
SSSSSSSSSSSSSS
SSSSSSSSSSSSSS
SSSSSSSSSSSSSS
--------------
--------------
--?-----------
SS??SSSSSSSSSS
S---SSSSSSSSSS
S---SSSSSSSSSS
S-o-SSSSSSSSSS
--XXXXXXXXXXXX
