--------------
--------------
--------------
--------------
--------------
--------------
--------------
--------------
--------------
--------------
--------------
-X------------
-X------------
-XXXXXXXXXX-XX
