--------------
--------------
--------------
--------------
--------XXX---
--------------
--------------
--------------
--------------
--------------
--------------
--------------
--------------
-----XXXXXXXXX
