--------------
--------------
--------------
--------------
--------------
----------oo--
--------------
XXXXXX--------
-----------XXX
--------------
--------------
--------------
--------------
--------------
