--------------
--------------
--------------
--------------
--------------
-------SSSS---
--------------
--------------
-E------------
<>------------
[]------------
[]------------
[]------------
XXX-XXXXXXXXXX
