--------------
--------------
--------------
--------------
-------EE-----
-------XXXX---
--------------
--------------
--------------
----XXXXXXXXX-
--------------
--------------
-------------X
XXX-----------
