--------------
--------------
--------------
--------------
--------------
--------------
--------------
-----------XXX
----------XX--
---------XXX--
---------XXX--
--------XXXX--
-----E---XXX--
XXXXXXXXXXXXXX
