--------------
--------------
--------------
--------------
--------------
--------------
--------------
--------------
---------oo---
--------------
--------------
--------------
--------------
XXXXXXXXXX-XXX
