--------------
--------------
SSSSSSSSSSSSSS
--------SSSSSS
--------SSSSSS
--------SSSSSS
--------SS----
--------------
--------------
--Q-------SSSS
----------SSSS
-----------SSS
--------------
XXX--X---XXXXX
