--------------
--------------
SSSSSSSSSSSSSS
----------SSSS
----------SSSS
----------SSSS
--------------
--------------
--------------
-----------SSS
--------------
--------------
--------------
--X-------XXXX
