--------------
--------------
--------------
--------------
---------Eoo--
---------XXXXX
--------------
--------------
--X-----------
-------XXXXXXX
--------------
--------------
--------------
--------------
