--------------
--------------
--------------
--------------
--------------
--------------
-------XX-----
-----X-----X--
--------------
XXX-----------
--------------
--------------
--------------
-----------XXX
