--------------
--------------
--------------
--------------
--------------
SSSS----------
--------------
--------------
--------------
--------------
--------------
--------------
--EEEE--------
XXXXXXXXXXXXXX
