--------------
--------------
--------------
--------------
--------------
--------------
--------------
--------------
-------------E
-----------SSS
--------------
--------------
------E-------
XXXXXXX-XXXXXX
