--------------
--------------
SSSSSSSSSSSSSS
SSSS--SSSS----
SSSS--SSSS----
SS-----SSS----
SS------------
S-------------
SS------------
SSSS---SSS----
--------------
--------------
-E------------
XXXXXXXXXXX-XX
