--------------
--------------
--------------
--------------
--------------
--------XX----
-------XX-----
------XXX-----
-----XXXX-----
-----XXXX-----
---XXXXXX-----
---XXXXXX-----
---XXXXXX-----
XXXXXXXXXXXXXX
