--------------
--------------
--------------
--------------
--------------
--------------
-oo----------X
XX------------
--------------
--------------
--------XXX---
--------------
--------------
XXXXXXX------X
