--------------
--------------
--------------
--------------
--------------
--SSSS--------
--------------
--------------
--------------
--XXXX--------
--------------
--------------
--------------
XXX------XXXX-
