--------------
--------------
--------------
--------------
--------------
---------XXXX-
---XXX--------
--------------
------------XX
XX------------
--------------
--------------
---X----------
--------------
