--------------
--------------
--------------
--------------
--------------
--------------
--------------
--------------
--------------
--------------
--------------
--------------
EE------E--E--
XXXXXXXXXXXXXX
