--------------
--------------
--------------
--------------
--------------
--------------
--------------
--------------
-------------E
---------SSSSS
------E-------
--------------
--------------
XXXXXXXXXXXXXX
