--------------
--------------
SSSSSSSSSSSSSS
--------------
--------------
-----ooo------
--------------
----SS--------
----SSSS------
--------------
--------------
--------------
--------------
---XXXXXXXXX-X
