--------------
--------------
--------------
--------------
--------------
--------------
--------------
--------------
--------------
------------E-
-----------<>-
-----------[]-
----EEE----[]E
XXXXXXXXXXXXXX
