--------------
--------------
--------------
--------------
XX------------
--------------
--------------
--------------
--------------
--------------
----------XXXX
--------------
--------------
XXXXXXXXX-----
