--------------
--------------
--------------
--------------
--------------
--------------
--------------
--------------
--------------
-----QQ-------
--------------
-B------------
-b------------
XXXXXXXXXXXXXX
