--------------
--------------
--------------
--------------
--------------
--S-----------
--------------
--------------
--------------
--------------
---------E----
--------<>----
EE-E----[]----
XXXXXXXXXXXXXX
