--------------
--------------
SSSSSSSSSSSSSS
--------------
--------------
--------------
--------------
--------------
--------------
--------------
----XXX--XX---
---XXXX--XXX--
--XXXX---XXX--
XXXXX-XXXXXXXX
