--------------
--------------
--------------
--------------
--------------
--------------
--------------
--------------
--------------
--------------
--------XXX---
-------XXXXX--
------XXXX----
XXXXXXXX-X----
