--------------
--------------
SSSSSSSSSSSSSS
SSSSSSSSSS----
SSSSSSSSS-----
SSSSSSSS------
--------------
--------------
--------------
--SSSSSS------
--SSSSSS-----E
-SSSSSS-----<>
------------[]
-XXXXXXXXXXXXX
