--------------
--------------
--------------
--------------
--------------
--------------
--------------
--------------
-SSS----------
--------------
--------------
--------------
--------------
--XXXXXXX---XX
