--------------
--------------
SSSSSSSSSSSSSS
------SSSSSSSS
-------SSSSSSS
------SSSSSSSS
------SS------
------S-------
-----------ooo
---------SSSSS
--------SS----
--------------
-------E------
XX-----XXXXXXX
