--------------
--------------
--------------
--------------
--------------
--------------
--------------
--------------
--------------
--------------
--------------
--------------
---------EEE--
---XXXXXXXXXXX
