--------------
--------------
--------------
--------------
--------------
--------------
--------------
--------------
-------------E
Q-Q---------<>
------------[]
------------[]
----EE-EE---[]
XXXXXXXXXXXXXX
