--------------
--------------
--------------
--------------
--------------
--SSSSSSSS----
--------------
--------------
--------------
SSSS----------
--------------
--------------
----------EE-E
XXXXXXXXXXXXXX
