--------------
--------------
--------------
--------------
XXX-----------
--------------
------X-------
--------------
--------------
--------------
--------------
-------XX-----
--------------
XXXX----------
