--------------
--------------
--------------
--------------
--------------
--------------
--------------
--------------
--------o-----
--E-----------
-<>-----------
-[]-----------
-[]-----------
XXXXXXXXXXXXXX
