--------------
--------------
--------------
--------------
--------------
--------------
--------------
--------------
--------------
--------------
--------------
--------------
-------E-E-E--
XXXXXXXXXXXXXX
