--------------
--------------
--------------
--------------
--------------
--------------
--------------
--------------
--------------
---Q-QQ-------
--------------
--------------
--------------
XXXXXXXXXXXXXX
