--------------
--------------
--------------
--------------
--------------
--------------
-----S--------
---------X----
SS------XX----
-------XXX----
------XXXX----
-----XXXXX----
----XXXXXX----
XXXXXXXXXXXXXX
