--------------
--------------
-------------o
-----------XXX
--------------
--------------
--------------
--------------
--------------
----XXXXX-----
--------------
----------XXX-
--------------
-XXXX---------
