--------------
--------------
-S--SSSSSSSSSS
--------------
--------------
--------------
--------------
SSS-----------
--------------
--------------
--------------
--------------
--------------
-----XXXXXX---
