--------------
--------------
--------------
--------------
--------------
--------------
--------------
--------------
--------------
--------------
-----E--------
----<>--------
----[]--------
XXXXXXXXXXXXXX
