--------------
--------------
--------------
--------------
--------------
--------------
-------------X
-------------X
-----------XXX
----------XXXX
---------XXXXX
--------XXXXXX
---E-----X-XXX
XXXXXXXXXX-XXX
