--------------
--------------
--------------
--------------
--------------
----------X---
---------XX---
---------XX---
-------X-XX---
------X--XX---
----XXX-XXX---
---XXXX--XX---
--XXXXX--XXX--
XXXX--X--XXXXX
