--------------
--------------
---SSSSSSSSSSS
--------------
--------------
--------------
--------------
--------------
--------------
------------Q-
--------------
--------------
--------------
X-XXXXXXX---XX
