--------------
--------------
--------------
--------------
--------------
---SSSSS------
--------------
--------------
--------------
---SSSSS------
--------------
--------------
--------------
XXXXXXXXXXXXXX
