--------------
--------------
--------------
--------------
--------------
SSSSS---------
--------------
--------------
--------------
--------------
--------------
--------------
--------------
XXXXXXXXXXXX--
