--------------
--------------
--------------
--------------
--------------
---------XX---
--------XXX---
--------XXX---
-------XXXX---
-----XXX-XX---
-----XX--XX---
-----XXX-XX---
-----XXXXXX---
XXXXXXX--XXXXX
