--------------
--------------
--------------
--------------
--------------
--------------
--------------
--------------
--------------
--------------
-------E------
------<>------
E-----[]------
XXXXXXXXXXXXXX
