--------------
--------------
--------------
--------------
--------------
--------------
--------------
--------------
--------------
--------------
--------E-----
-----B-------X
-----b--------
XXXXXXXXXXXXXX
