--------------
--------------
--------------
--------------
--------------
-------E--E---
---------XXXXX
--------------
--------------
---XXX--------
--------------
--------------
--------------
XX------------
