--------------
--------------
--------------
--------------
--------------
--------------
--------------
--------XX----
-------XXX----
------XXXX----
----XXXXXX----
---XXXXXXX----
---XXXXXXX----
XXXXXXXXXXXXXX
