--------------
--------------
--------------
--------------
--------------
--------------
--------------
--------------
--------------
--XXXX--------
--------------
--------------
-------------E
--------XXXXX-
