--------------
--------------
SSSSSSS------S
--------------
--------------
--------------
--------------
--------------
-------------S
--QQQQ--------
--------------
--------------
--------------
XXXXXXX------X
