--------------
--------------
SSSSSSSSSSSSSS
SS--SSSSS-----
SS--SSSSS-----
SS----------oS
------------SS
------------SS
------------SS
SS--SSSS----S-
SS------------
S-------------
--------------
XXXXXXXX----XX
