--------------
--------------
--SSSSSSSSSSSS
--SSSSSSSS--SS
--SSSSSSSS---S
--SSSSSSSS--SS
--SS----------
--S-----------
---?-o--------
---?SSSSSS---Q
--------------
X-------------
--------------
--XXXXXXXX-XXX
