--------------
--------------
--------------
--------------
--------------
--------------
--------------
--------------
--------------
-------X------
------XXX-----
-----XXXXX----
----XXXXX-----
XXXXXXXX------
