--------------
--------------
--------------
--------------
--------------
-SSSSSSS------
--------------
--------------
--------------
SSSSSSSS----<>
------------[]
------------[]
------------[]
XXXXXXXXXXXXXX
