--------------
--------------
--------------
--------------
--------------
------SS------
--------------
--------------
--------------
--------------
--------------
--------------
-------------E
XXXXX----XXXXX
