--------------
--------------
--------------
--------------
--------------
--------------
--------------
--------------
--------------
------X----XX-
--XX--XX------
-XXX---XX--XXX
XXXX---XX--X-X
XX---XXXXXXXXX
