--------------
--------------
SSSSSSSSSSSSSS
--------------
--------------
--------------
--------------
--------------
--E-----------
--E---------Q-
-<>-----------
-[]-----------
-[]-----------
XXXXXX-XXX-XXX
