--------------
--------------
------------SS
--------------
--------------
---------SS-S-
--------------
--------------
--------------
----------S-S-
--------------
--------------
--------------
XXX------XXXXX
