--------------
--------------
--------------
--------------
--------------
--------------
--------------
--XXXXXXX-----
--------------
-------------X
--------------
--------------
----------ooo-
----------XXX-
