--------------
--------------
--------------
--------------
--------------
--------------
--------------
----------E---
---------<>---
SS-------[]---
---------[]---
---------[]---
---------[]---
XXXXXXXXXXXXXX
