--------------
--------------
--------------
--------------
--------------
--------------
--------------
--------------
----SSSSS-----
--------------
--------------
--------------
--------------
---XXXXXXXXXXX
