--------------
--------------
--------------
--------------
--------------
--------------
------XXX-----
--------------
--------------
XXXX-------XX-
--------------
--------------
--------------
----X---------
