--------------
--------------
--------------
--------------
--------------
-----------XXX
-----------XXX
-----------XXX
---------XXXXX
--------XXXXXX
-------XXXXXXX
------XXXXXXXX
----XXXXXXXXXX
XXXXXXXXXXXXXX
