--------------
--------------
SSSSSSSSSSSSSS
--------------
--------------
--------------
--------------
--------------
--------------
--------------
------XX-<>--X
-----XXX-[]--X
E----XXX-[]--X
XXXXXXX--XX--X
