--------------
--------------
--------------
--------------
--------------
------XX------
-----XXXSS----
----XXXX------
-EXXXXXX------
<>XXXXXX------
[]XXXXXX-SSS--
[]XXXXXX------
[]XXXXX-------
XXXXXXXXXX---X
