--------------
--------------
--------------
--------------
--------------
--------------
---E----------
-XXXXXXXX-----
-------------X
--------------
--------------
--------------
------------oo
------------X-
