--------------
--------------
--------------
--------------
--------------
--------------
--------------
--------------
-------------E
-----X--------
----XXX-------
---XXXX-------
--XXXXX-------
XXXXXXX------X
