--------------
--------------
--------------
--------------
--------------
--------------
--------------
--------------
--------------
--------------
---------E----
---B----------
---b-------E--
XXXXXXXXXXXXXX
