----------------------------------------------------------------------------------------------------------------------------------------------------------------------------------------------------------------------------------------------------
----------------------------------------------------------------------------------------------------------------------------------------------------------------------------------------------------------------------------------------------------
----------------------------------------------------------------------------------------------------------------------------------------------------------------------------------------------------------------------------------------------------
----------------------------------------------------------------------------------------------------------------------------------------------------------------------------------------------------------------------------------------------------
------------------------------------------------------------------------------------------------------------------------------------------------------------------------------------------------------------------------------------E---------------
--------------------------------------------------------------------------E-------------------XX------------------------QQQ?QQQQQQQQ?QQQQ-----------X------------------------------------------------------------------------------<>---------------
------------X--EX--------------------------------------------------------<>-------------------[]--------------------------------------[]-----------XX----XX------XX---------------------------------------------------------------X[]---------------
------------X---X--------------------------------------------------------[]-------------------[]--------------------------------------[]----------XXXXX-------------------------------------------------------------------E------XX[]---------------
------X---X-X---X--------X-EE----X-------------ooo----------------E------[]-------------------[]--------------------------------------[]---------XXXX---------------------------------------------------------------------------EXX[]---------------
------XSSSX-XSS?X--------XSSSSSSSX-------------ooo----------------------S[]-------------------<>SSSSSS--------------------SSSSSSSSSSS-<>--------XXXXX-----------------------XX-------------------------------------------------<>XX[]------------S--
--------------------------------------------------------------oo---------[]------------X-------------------------------------------------------XXXXXX----------------------XXX-------------------------------E----------------X[]XX[]---------------
--------------------------------------------------------------oo---------[]------------XX------E-------------------------E---E----------------XXXXXXX---------------------XXXX------------------------------<>---------------XX[]XX[]----------SS-SS
-------------------------------------------------------------------------[]------B-----XXXX------E-------------------------------------E-----XXXXXXXX--------------------XXXXX------------------E-----------[]--------------XXX[]XX[]--------X-SS-SS
XXXXXXXXXXXXXXXXXXXXXX--XXXXXXXXXXXXXXXXXXXXXXXXXXXXXXXXXXXXXXXXXXXXXXXXXXXXXXXXXX-----XXXXXXXXXXXXXXXXXXXXXXXXXXXXXXXXXXXXXXXXXXXXXXXXX-XXXXXXXXXXXX--------------------XXXXXXXXXXXXXXXXXXXXXXXX-----------XXXXXXXXXXX----XXXXXXXXXXXXXXXXXXXXXXXX-