---------------------------------------------------------------------------------------------------------------------------------------------------------------------------------------------------------
---------------------------------------------------------------------------------------------------------------------------------------------------------------------------------------------------------
-----------------------------------------------------------------------------------------------------------------------------------------------------------------------------------------------E---------
---------------------------------------------------------------------------------------------------------------------------------------------------------------------------------------------------------
-----------------------------------------------------------E---------------------------------------------------------------------------------------------------------------------------------------------
-------------------------------------------------------SSSSSSSSSS-------------------------------------------------------------------------------------------------------------------------------XX-------
---------------------------------------------------------------------------------------------------------------------------------------------------------------------------------------------------------
---------------------------------------------------------------------------------------------------------------------------------------------------------------------------------------------------------
--------------------B--------------------------------------------------X----------------------------------------<>-------------------------------------------------------E---------------X---X-----------
------------B-------b------------------------------------------SSSSSSSSX----------------------------------------[]----?QQQQQQQ?-------------------------------------QQQQQQQ-----------X------------------
------------b--?-B------?QQ-------------------------------X-----------------------------------------------------[]-------------------------------------XXXXXXXXXXXXX------------------X------------------
------------B----b----------------------------------------X-----------------------------------------------------[]----B------------------?------------------------------------<>------X------------------
------------b----B----------------------------------------X-------------------E---------E-E-------------E-E-----[]----b-E-----B------E------------E---------------------------[]------X--------X---------
XXXXXXXXXXXXXXXXXXXXXXXXXXXXXXXXXXXXXXXX--XXXXXXX--X-XXXXXXXXXXXXXXXXXXXXXXXXXXXXXXXXXXXXXXXXXXXXXXXXXXXXXXXXXXXXXXXXXXXXXXX-XXXXXXXXXXXX-XXXXXXXXXXXXXXXXXXXXXXXXXXXX-XXXX---XXXXXXXXX----XXXXX---------