-------------------------------------------------------------------------------------------------------------------------------------------------------------------------------------------------
-------------------------------------------------------------------------------------------------------------------------------------------------------------------------------------------------
-------------------------------------------------------------------------------------------------------------------------------------------------------------------------------------------------
-------------------------------------------------------------------------------------------------------------------------------------------------------------------------------------------------
-------------------------------------------------------------------------------------------------------------------------------------------------------------------------------------------------
--------------------------------------------------------------------------------------------------------------------------------------------------E-E-E------------S------------------XS---------
---------------------------------------------------------------------------------------------------X---------------------------------------------<><><>------------------------------EX----------
--------------------------------------------------------------------------------------------------XX--------------------E------------------------[][][]-----------------------------XXX----------
----------------------------S--------------------------------------------------------------------XXX-------------------<>--------------------Q?--QQQQQQ-------------------E--------XXXXS---------
----------------------------------------------<>------------------------------------------------XXXX---------------QQ?-[]---------------------------------------Q--------<>-------XXXXX----------
--------------------E---------------X---------[]-------QQQQQQ?---------------------------------XXXXX-------------------[]------------------------------------E------<>---[]------XXXXXX----------
-------------------<>-------S-------X---------[]----------------------------------------------XXXXXX-------------------[]-----------------------------------<>------[]---[]-----XXXXXXX----------
-------------------[]----E--S-------X---------[]-------------------X-----X-----X-------------XXXXXXX--------------X----[]-----------------------------------[]------[]---[]----XXXXXXXX---------X
XXXXXXXXXXXXXXXXXXXXXXXXXXXXXXXXXXXXXXXXXXXXXXXXXXXXXXXXXXXXXXXXXXXX-----X-----XXXXXXXXXXXXXXXXXXXXXXXXXXXXXXXXXXXXXXXXXXXXXXXXXXXXXXXXXXXXXXXX--XXXXXXXXXXXXXX-XXX-XX--XXXXX-XXXXXXXXXXXXXXXXX-X