-----------------------------------------------------------------------------------------------------------------------------------------------------------------------------------------------------------------
-----------------------------------------------------------------------------------------------------------------------------------------------------------------------------------------------------------------
---------------SS-------------------XXXX-------------------------------------------------------------------------------------------------------------------------------------------------------------------------
---------------[]--------------------[]--------------------------------------------------------------------------------------------------------------------------------------------------------------------------
---------------[]--------------------[]--------------------------------------------------------------------------------------------------------------------------------------------------------------------------
---------------<>--------------------[]--------------------------------------E---XX--------------SSSS-----------------------------------------------SSSSS-----SSSSS---------X----E---------------------X---------
-------------------------------------[]-----------------------------------E--E---[]---------------[]-----------------------------------------------S-----------[]---------------<>-------------------------------
----------------E--------------------[]------------------------------------------[]---------------[]------------------------E---------------------SS-----------[]---------------[]-----------------E-------------
---------------E---------------------[]--------------------------------E---------[]---------------[]---------------------------------------------SSS-------?---[]---------E-----[]----------------<>-------------
--------------<>---QQQQQQ?QQQQQQQ?Q--<>-------X----------------------------------[]---------------[]-----------------------S---S----------------SSSS-----------<>--------<>-----[]------------?---[]-------------
--------------[]------------------------------X----------------------------------<>-----B---------<>-----------E---------------------------------------------------------[]-----[]----------------[]-------------
--------------[]--------------------------E---X-----------------------------------------b---------------------<>-X-X---------------------E----------------------E--------[]-----[]----------------[]-------------
--------------[]-----------------------------EX-------------------X---------------E-----B----------E----------[]-X-X--------------------E-------B------------B-----------[]-----[]------E---------[]------------X
XXXXXXXXXXXXXXXXXXXXXXXXXXXXXXXXXXXXXXXXXXXXXXX-----XXXXXXXXXXXXXXX-------------XXXXXXXXXXXXXXXXXXXXXXXXEXXXXXXXXXXX-------------XXXXXXXXXXXXXXXXXXXXXXXXXXXXX-XXXXXXXEXXXX-----XXXXXXXXXXXXXXX---XXXXXXX-------X